"partijos_no";"partija_full";"apylinkes";"pastas";"balsai";"proc_rinkejai";"proc_rinkejai_lt";"apygarda";"apygardos_no";"partija"
2;"Tėvynės sąjunga - Lietuvos krikščionys demokratai";"7148";"3811";"10959";"40,97";"21,66";"Naujamiesčio";1;"TSLKD"
6;"Lietuvos valstiečių ir žaliųjų sąjunga";"1575";"670";"2245";"8,39";"21,54";"Naujamiesčio";1;"LVZS"
1;"Lietuvos socialdemokratų partija";"1735";"450";"2185";"8,17";"14,43";"Naujamiesčio";1;"LSDP"
7;"Lietuvos Respublikos liberalų sąjūdis";"3440";"1873";"5313";"19,86";"9,04";"Naujamiesčio";1;"LRLS"
14;"Antikorupcinė N. Puteikio ir K. Krivicko koalicija (Lietuvos centro partija, Lietuvos pensininkų partiją)";"413";"287";"700";"2,62";"6,06";"Naujamiesčio";1;"PUTKA"
11;"Lietuvos lenkų rinkimų akcija-Krikščioniškų šeimų sąjunga";"809";"84";"893";"3,34";"5,49";"Naujamiesčio";1;"LLRA"
5;"Partija Tvarka ir teisingumas";"393";"146";"539";"2,01";"5,33";"Naujamiesčio";1;"PTT"
8;"Darbo partija";"425";"133";"558";"2,09";"4,69";"Naujamiesčio";1;"DP"
3;"Lietuvos laisvės sąjunga (liberalai)";"694";"229";"923";"3,45";"2,14";"Naujamiesčio";1;"LLS"
12;"Lietuvos žaliųjų partija";"363";"224";"587";"2,19";"1,94";"Naujamiesčio";1;"LZS"
13;"Politinė partija „Lietuvos sąrašas“";"449";"240";"689";"2,58";"1,72";"Naujamiesčio";1;"LS"
10;"Lietuvos liaudies partija";"234";"284";"518";"1,94";"1,01";"Naujamiesčio";1;"LLP"
4;"S. Buškevičiaus ir Tautininkų koalicija „Prieš korupciją ir skurdą“ (Partija „Jaunoji Lietuva“, Tautininkų sąjunga)";"113";"65";"178";"0,67";"0,54";"Naujamiesčio";1;"JL"
9;"„Drąsos kelias“ politinė partija";"24";"16";"40";"0,15";"0,28";"Naujamiesčio";1;"DK"
2;"Tėvynės sąjunga - Lietuvos krikščionys demokratai";"6809";"970";"7779";"36,86";"21,66";"Senamiesčio";2;"TSLKD"
6;"Lietuvos valstiečių ir žaliųjų sąjunga";"1632";"195";"1827";"8,66";"21,54";"Senamiesčio";2;"LVZS"
1;"Lietuvos socialdemokratų partija";"1834";"218";"2052";"9,72";"14,43";"Senamiesčio";2;"LSDP"
7;"Lietuvos Respublikos liberalų sąjūdis";"3085";"404";"3489";"16,53";"9,04";"Senamiesčio";2;"LRLS"
14;"Antikorupcinė N. Puteikio ir K. Krivicko koalicija (Lietuvos centro partija, Lietuvos pensininkų partiją)";"508";"130";"638";"3,02";"6,06";"Senamiesčio";2;"PUTKA"
11;"Lietuvos lenkų rinkimų akcija-Krikščioniškų šeimų sąjunga";"1235";"73";"1308";"6,20";"5,49";"Senamiesčio";2;"LLRA"
5;"Partija Tvarka ir teisingumas";"468";"57";"525";"2,49";"5,33";"Senamiesčio";2;"PTT"
8;"Darbo partija";"369";"54";"423";"2,00";"4,69";"Senamiesčio";2;"DP"
3;"Lietuvos laisvės sąjunga (liberalai)";"1135";"116";"1251";"5,93";"2,14";"Senamiesčio";2;"LLS"
12;"Lietuvos žaliųjų partija";"321";"31";"352";"1,67";"1,94";"Senamiesčio";2;"LZS"
13;"Politinė partija „Lietuvos sąrašas“";"581";"61";"642";"3,04";"1,72";"Senamiesčio";2;"LS"
10;"Lietuvos liaudies partija";"159";"20";"179";"0,85";"1,01";"Senamiesčio";2;"LLP"
4;"S. Buškevičiaus ir Tautininkų koalicija „Prieš korupciją ir skurdą“ (Partija „Jaunoji Lietuva“, Tautininkų sąjunga)";"101";"10";"111";"0,53";"0,54";"Senamiesčio";2;"JL"
9;"„Drąsos kelias“ politinė partija";"31";"2";"33";"0,16";"0,28";"Senamiesčio";2;"DK"
2;"Tėvynės sąjunga - Lietuvos krikščionys demokratai";"7426";"828";"8254";"37,74";"21,66";"Antakalnio";3;"TSLKD"
6;"Lietuvos valstiečių ir žaliųjų sąjunga";"2163";"178";"2341";"10,70";"21,54";"Antakalnio";3;"LVZS"
1;"Lietuvos socialdemokratų partija";"2239";"212";"2451";"11,21";"14,43";"Antakalnio";3;"LSDP"
7;"Lietuvos Respublikos liberalų sąjūdis";"3168";"246";"3414";"15,61";"9,04";"Antakalnio";3;"LRLS"
14;"Antikorupcinė N. Puteikio ir K. Krivicko koalicija (Lietuvos centro partija, Lietuvos pensininkų partiją)";"408";"48";"456";"2,09";"6,06";"Antakalnio";3;"PUTKA"
11;"Lietuvos lenkų rinkimų akcija-Krikščioniškų šeimų sąjunga";"1239";"73";"1312";"6,00";"5,49";"Antakalnio";3;"LLRA"
5;"Partija Tvarka ir teisingumas";"441";"51";"492";"2,25";"5,33";"Antakalnio";3;"PTT"
8;"Darbo partija";"348";"56";"404";"1,85";"4,69";"Antakalnio";3;"DP"
3;"Lietuvos laisvės sąjunga (liberalai)";"880";"82";"962";"4,40";"2,14";"Antakalnio";3;"LLS"
12;"Lietuvos žaliųjų partija";"408";"26";"434";"1,98";"1,94";"Antakalnio";3;"LZS"
13;"Politinė partija „Lietuvos sąrašas“";"496";"32";"528";"2,41";"1,72";"Antakalnio";3;"LS"
10;"Lietuvos liaudies partija";"179";"13";"192";"0,88";"1,01";"Antakalnio";3;"LLP"
4;"S. Buškevičiaus ir Tautininkų koalicija „Prieš korupciją ir skurdą“ (Partija „Jaunoji Lietuva“, Tautininkų sąjunga)";"101";"7";"108";"0,49";"0,54";"Antakalnio";3;"JL"
9;"„Drąsos kelias“ politinė partija";"21";"3";"24";"0,11";"0,28";"Antakalnio";3;"DK"
2;"Tėvynės sąjunga - Lietuvos krikščionys demokratai";"5445";"689";"6134";"31,75";"21,66";"Žirmūnų";4;"TSLKD"
6;"Lietuvos valstiečių ir žaliųjų sąjunga";"1989";"179";"2168";"11,22";"21,54";"Žirmūnų";4;"LVZS"
1;"Lietuvos socialdemokratų partija";"2112";"206";"2318";"12,00";"14,43";"Žirmūnų";4;"LSDP"
7;"Lietuvos Respublikos liberalų sąjūdis";"2362";"268";"2630";"13,61";"9,04";"Žirmūnų";4;"LRLS"
14;"Antikorupcinė N. Puteikio ir K. Krivicko koalicija (Lietuvos centro partija, Lietuvos pensininkų partiją)";"590";"49";"639";"3,31";"6,06";"Žirmūnų";4;"PUTKA"
11;"Lietuvos lenkų rinkimų akcija-Krikščioniškų šeimų sąjunga";"1630";"68";"1698";"8,79";"5,49";"Žirmūnų";4;"LLRA"
5;"Partija Tvarka ir teisingumas";"514";"64";"578";"2,99";"5,33";"Žirmūnų";4;"PTT"
8;"Darbo partija";"438";"38";"476";"2,46";"4,69";"Žirmūnų";4;"DP"
3;"Lietuvos laisvės sąjunga (liberalai)";"826";"74";"900";"4,66";"2,14";"Žirmūnų";4;"LLS"
12;"Lietuvos žaliųjų partija";"300";"30";"330";"1,71";"1,94";"Žirmūnų";4;"LZS"
13;"Politinė partija „Lietuvos sąrašas“";"658";"43";"701";"3,63";"1,72";"Žirmūnų";4;"LS"
10;"Lietuvos liaudies partija";"136";"8";"144";"0,75";"1,01";"Žirmūnų";4;"LLP"
4;"S. Buškevičiaus ir Tautininkų koalicija „Prieš korupciją ir skurdą“ (Partija „Jaunoji Lietuva“, Tautininkų sąjunga)";"63";"15";"78";"0,40";"0,54";"Žirmūnų";4;"JL"
9;"„Drąsos kelias“ politinė partija";"19";"3";"22";"0,11";"0,28";"Žirmūnų";4;"DK"
2;"Tėvynės sąjunga - Lietuvos krikščionys demokratai";"5765";"430";"6195";"30,64";"21,66";"Fabijoniškių";5;"TSLKD"
6;"Lietuvos valstiečių ir žaliųjų sąjunga";"2478";"130";"2608";"12,90";"21,54";"Fabijoniškių";5;"LVZS"
1;"Lietuvos socialdemokratų partija";"1978";"96";"2074";"10,26";"14,43";"Fabijoniškių";5;"LSDP"
7;"Lietuvos Respublikos liberalų sąjūdis";"2886";"212";"3098";"15,32";"9,04";"Fabijoniškių";5;"LRLS"
14;"Antikorupcinė N. Puteikio ir K. Krivicko koalicija (Lietuvos centro partija, Lietuvos pensininkų partiją)";"724";"35";"759";"3,75";"6,06";"Fabijoniškių";5;"PUTKA"
11;"Lietuvos lenkų rinkimų akcija-Krikščioniškų šeimų sąjunga";"1761";"65";"1826";"9,03";"5,49";"Fabijoniškių";5;"LLRA"
5;"Partija Tvarka ir teisingumas";"458";"27";"485";"2,40";"5,33";"Fabijoniškių";5;"PTT"
8;"Darbo partija";"523";"45";"568";"2,81";"4,69";"Fabijoniškių";5;"DP"
3;"Lietuvos laisvės sąjunga (liberalai)";"893";"59";"952";"4,71";"2,14";"Fabijoniškių";5;"LLS"
12;"Lietuvos žaliųjų partija";"322";"17";"339";"1,68";"1,94";"Fabijoniškių";5;"LZS"
13;"Politinė partija „Lietuvos sąrašas“";"522";"20";"542";"2,68";"1,72";"Fabijoniškių";5;"LS"
10;"Lietuvos liaudies partija";"199";"4";"203";"1,00";"1,01";"Fabijoniškių";5;"LLP"
4;"S. Buškevičiaus ir Tautininkų koalicija „Prieš korupciją ir skurdą“ (Partija „Jaunoji Lietuva“, Tautininkų sąjunga)";"103";"7";"110";"0,54";"0,54";"Fabijoniškių";5;"JL"
9;"„Drąsos kelias“ politinė partija";"19";"5";"24";"0,12";"0,28";"Fabijoniškių";5;"DK"
2;"Tėvynės sąjunga - Lietuvos krikščionys demokratai";"3888";"359";"4247";"24,66";"21,66";"Šeškinės";6;"TSLKD"
6;"Lietuvos valstiečių ir žaliųjų sąjunga";"2353";"133";"2486";"14,44";"21,54";"Šeškinės";6;"LVZS"
1;"Lietuvos socialdemokratų partija";"1949";"115";"2064";"11,99";"14,43";"Šeškinės";6;"LSDP"
7;"Lietuvos Respublikos liberalų sąjūdis";"1739";"125";"1864";"10,83";"9,04";"Šeškinės";6;"LRLS"
14;"Antikorupcinė N. Puteikio ir K. Krivicko koalicija (Lietuvos centro partija, Lietuvos pensininkų partiją)";"668";"30";"698";"4,05";"6,06";"Šeškinės";6;"PUTKA"
11;"Lietuvos lenkų rinkimų akcija-Krikščioniškų šeimų sąjunga";"2180";"87";"2267";"13,17";"5,49";"Šeškinės";6;"LLRA"
5;"Partija Tvarka ir teisingumas";"523";"30";"553";"3,21";"5,33";"Šeškinės";6;"PTT"
8;"Darbo partija";"648";"46";"694";"4,03";"4,69";"Šeškinės";6;"DP"
3;"Lietuvos laisvės sąjunga (liberalai)";"867";"61";"928";"5,39";"2,14";"Šeškinės";6;"LLS"
12;"Lietuvos žaliųjų partija";"243";"17";"260";"1,51";"1,94";"Šeškinės";6;"LZS"
13;"Politinė partija „Lietuvos sąrašas“";"392";"26";"418";"2,43";"1,72";"Šeškinės";6;"LS"
10;"Lietuvos liaudies partija";"168";"7";"175";"1,02";"1,01";"Šeškinės";6;"LLP"
4;"S. Buškevičiaus ir Tautininkų koalicija „Prieš korupciją ir skurdą“ (Partija „Jaunoji Lietuva“, Tautininkų sąjunga)";"60";"5";"65";"0,38";"0,54";"Šeškinės";6;"JL"
9;"„Drąsos kelias“ politinė partija";"18";"0";"18";"0,10";"0,28";"Šeškinės";6;"DK"
2;"Tėvynės sąjunga - Lietuvos krikščionys demokratai";"4065";"342";"4407";"25,69";"21,66";"Justiniškių";7;"TSLKD"
6;"Lietuvos valstiečių ir žaliųjų sąjunga";"2145";"112";"2257";"13,15";"21,54";"Justiniškių";7;"LVZS"
1;"Lietuvos socialdemokratų partija";"1869";"131";"2000";"11,66";"14,43";"Justiniškių";7;"LSDP"
7;"Lietuvos Respublikos liberalų sąjūdis";"1981";"132";"2113";"12,32";"9,04";"Justiniškių";7;"LRLS"
14;"Antikorupcinė N. Puteikio ir K. Krivicko koalicija (Lietuvos centro partija, Lietuvos pensininkų partiją)";"847";"37";"884";"5,15";"6,06";"Justiniškių";7;"PUTKA"
11;"Lietuvos lenkų rinkimų akcija-Krikščioniškų šeimų sąjunga";"2258";"82";"2340";"13,64";"5,49";"Justiniškių";7;"LLRA"
5;"Partija Tvarka ir teisingumas";"493";"32";"525";"3,06";"5,33";"Justiniškių";7;"PTT"
8;"Darbo partija";"512";"18";"530";"3,09";"4,69";"Justiniškių";7;"DP"
3;"Lietuvos laisvės sąjunga (liberalai)";"737";"31";"768";"4,48";"2,14";"Justiniškių";7;"LLS"
12;"Lietuvos žaliųjų partija";"295";"15";"310";"1,81";"1,94";"Justiniškių";7;"LZS"
13;"Politinė partija „Lietuvos sąrašas“";"398";"18";"416";"2,42";"1,72";"Justiniškių";7;"LS"
10;"Lietuvos liaudies partija";"126";"4";"130";"0,76";"1,01";"Justiniškių";7;"LLP"
4;"S. Buškevičiaus ir Tautininkų koalicija „Prieš korupciją ir skurdą“ (Partija „Jaunoji Lietuva“, Tautininkų sąjunga)";"87";"12";"99";"0,58";"0,54";"Justiniškių";7;"JL"
9;"„Drąsos kelias“ politinė partija";"21";"0";"21";"0,12";"0,28";"Justiniškių";7;"DK"
2;"Tėvynės sąjunga - Lietuvos krikščionys demokratai";"5372";"547";"5919";"28,50";"21,66";"Karoliniškių";8;"TSLKD"
6;"Lietuvos valstiečių ir žaliųjų sąjunga";"2799";"117";"2916";"14,04";"21,54";"Karoliniškių";8;"LVZS"
1;"Lietuvos socialdemokratų partija";"1925";"158";"2083";"10,03";"14,43";"Karoliniškių";8;"LSDP"
7;"Lietuvos Respublikos liberalų sąjūdis";"2567";"171";"2738";"13,19";"9,04";"Karoliniškių";8;"LRLS"
14;"Antikorupcinė N. Puteikio ir K. Krivicko koalicija (Lietuvos centro partija, Lietuvos pensininkų partiją)";"700";"32";"732";"3,52";"6,06";"Karoliniškių";8;"PUTKA"
11;"Lietuvos lenkų rinkimų akcija-Krikščioniškų šeimų sąjunga";"2072";"64";"2136";"10,29";"5,49";"Karoliniškių";8;"LLRA"
5;"Partija Tvarka ir teisingumas";"581";"33";"614";"2,96";"5,33";"Karoliniškių";8;"PTT"
8;"Darbo partija";"578";"32";"610";"2,94";"4,69";"Karoliniškių";8;"DP"
3;"Lietuvos laisvės sąjunga (liberalai)";"1058";"65";"1123";"5,41";"2,14";"Karoliniškių";8;"LLS"
12;"Lietuvos žaliųjų partija";"492";"24";"516";"2,48";"1,94";"Karoliniškių";8;"LZS"
13;"Politinė partija „Lietuvos sąrašas“";"438";"27";"465";"2,24";"1,72";"Karoliniškių";8;"LS"
10;"Lietuvos liaudies partija";"182";"10";"192";"0,92";"1,01";"Karoliniškių";8;"LLP"
4;"S. Buškevičiaus ir Tautininkų koalicija „Prieš korupciją ir skurdą“ (Partija „Jaunoji Lietuva“, Tautininkų sąjunga)";"79";"4";"83";"0,40";"0,54";"Karoliniškių";8;"JL"
9;"„Drąsos kelias“ politinė partija";"26";"2";"28";"0,13";"0,28";"Karoliniškių";8;"DK"
2;"Tėvynės sąjunga - Lietuvos krikščionys demokratai";"5073";"480";"5553";"28,99";"21,66";"Lazdynų";9;"TSLKD"
6;"Lietuvos valstiečių ir žaliųjų sąjunga";"2471";"132";"2603";"13,59";"21,54";"Lazdynų";9;"LVZS"
1;"Lietuvos socialdemokratų partija";"1942";"147";"2089";"10,91";"14,43";"Lazdynų";9;"LSDP"
7;"Lietuvos Respublikos liberalų sąjūdis";"2405";"213";"2618";"13,67";"9,04";"Lazdynų";9;"LRLS"
14;"Antikorupcinė N. Puteikio ir K. Krivicko koalicija (Lietuvos centro partija, Lietuvos pensininkų partiją)";"595";"35";"630";"3,29";"6,06";"Lazdynų";9;"PUTKA"
11;"Lietuvos lenkų rinkimų akcija-Krikščioniškų šeimų sąjunga";"2060";"80";"2140";"11,17";"5,49";"Lazdynų";9;"LLRA"
5;"Partija Tvarka ir teisingumas";"565";"39";"604";"3,15";"5,33";"Lazdynų";9;"PTT"
8;"Darbo partija";"538";"28";"566";"2,96";"4,69";"Lazdynų";9;"DP"
3;"Lietuvos laisvės sąjunga (liberalai)";"709";"48";"757";"3,95";"2,14";"Lazdynų";9;"LLS"
12;"Lietuvos žaliųjų partija";"287";"15";"302";"1,58";"1,94";"Lazdynų";9;"LZS"
13;"Politinė partija „Lietuvos sąrašas“";"440";"17";"457";"2,39";"1,72";"Lazdynų";9;"LS"
10;"Lietuvos liaudies partija";"174";"10";"184";"0,96";"1,01";"Lazdynų";9;"LLP"
4;"S. Buškevičiaus ir Tautininkų koalicija „Prieš korupciją ir skurdą“ (Partija „Jaunoji Lietuva“, Tautininkų sąjunga)";"74";"9";"83";"0,43";"0,54";"Lazdynų";9;"JL"
9;"„Drąsos kelias“ politinė partija";"32";"2";"34";"0,18";"0,28";"Lazdynų";9;"DK"
2;"Tėvynės sąjunga - Lietuvos krikščionys demokratai";"3254";"299";"3553";"21,49";"21,66";"Naujosios Vilnios";10;"TSLKD"
6;"Lietuvos valstiečių ir žaliųjų sąjunga";"1478";"74";"1552";"9,39";"21,54";"Naujosios Vilnios";10;"LVZS"
1;"Lietuvos socialdemokratų partija";"1404";"97";"1501";"9,08";"14,43";"Naujosios Vilnios";10;"LSDP"
7;"Lietuvos Respublikos liberalų sąjūdis";"1591";"124";"1715";"10,38";"9,04";"Naujosios Vilnios";10;"LRLS"
14;"Antikorupcinė N. Puteikio ir K. Krivicko koalicija (Lietuvos centro partija, Lietuvos pensininkų partiją)";"380";"28";"408";"2,47";"6,06";"Naujosios Vilnios";10;"PUTKA"
11;"Lietuvos lenkų rinkimų akcija-Krikščioniškų šeimų sąjunga";"3509";"199";"3708";"22,43";"5,49";"Naujosios Vilnios";10;"LLRA"
5;"Partija Tvarka ir teisingumas";"927";"54";"981";"5,93";"5,33";"Naujosios Vilnios";10;"PTT"
8;"Darbo partija";"884";"55";"939";"5,68";"4,69";"Naujosios Vilnios";10;"DP"
3;"Lietuvos laisvės sąjunga (liberalai)";"730";"38";"768";"4,65";"2,14";"Naujosios Vilnios";10;"LLS"
12;"Lietuvos žaliųjų partija";"242";"12";"254";"1,54";"1,94";"Naujosios Vilnios";10;"LZS"
13;"Politinė partija „Lietuvos sąrašas“";"262";"11";"273";"1,65";"1,72";"Naujosios Vilnios";10;"LS"
10;"Lietuvos liaudies partija";"236";"11";"247";"1,49";"1,01";"Naujosios Vilnios";10;"LLP"
4;"S. Buškevičiaus ir Tautininkų koalicija „Prieš korupciją ir skurdą“ (Partija „Jaunoji Lietuva“, Tautininkų sąjunga)";"68";"5";"73";"0,44";"0,54";"Naujosios Vilnios";10;"JL"
9;"„Drąsos kelias“ politinė partija";"24";"3";"27";"0,16";"0,28";"Naujosios Vilnios";10;"DK"
2;"Tėvynės sąjunga - Lietuvos krikščionys demokratai";"3034";"228";"3262";"21,19";"21,66";"Panerių";11;"TSLKD"
6;"Lietuvos valstiečių ir žaliųjų sąjunga";"1825";"83";"1908";"12,39";"21,54";"Panerių";11;"LVZS"
1;"Lietuvos socialdemokratų partija";"1250";"98";"1348";"8,76";"14,43";"Panerių";11;"LSDP"
7;"Lietuvos Respublikos liberalų sąjūdis";"1684";"131";"1815";"11,79";"9,04";"Panerių";11;"LRLS"
14;"Antikorupcinė N. Puteikio ir K. Krivicko koalicija (Lietuvos centro partija, Lietuvos pensininkų partiją)";"501";"58";"559";"3,63";"6,06";"Panerių";11;"PUTKA"
11;"Lietuvos lenkų rinkimų akcija-Krikščioniškų šeimų sąjunga";"2374";"135";"2509";"16,30";"5,49";"Panerių";11;"LLRA"
5;"Partija Tvarka ir teisingumas";"645";"44";"689";"4,48";"5,33";"Panerių";11;"PTT"
8;"Darbo partija";"975";"73";"1048";"6,81";"4,69";"Panerių";11;"DP"
3;"Lietuvos laisvės sąjunga (liberalai)";"631";"42";"673";"4,37";"2,14";"Panerių";11;"LLS"
12;"Lietuvos žaliųjų partija";"412";"31";"443";"2,88";"1,94";"Panerių";11;"LZS"
13;"Politinė partija „Lietuvos sąrašas“";"314";"19";"333";"2,16";"1,72";"Panerių";11;"LS"
10;"Lietuvos liaudies partija";"161";"15";"176";"1,14";"1,01";"Panerių";11;"LLP"
4;"S. Buškevičiaus ir Tautininkų koalicija „Prieš korupciją ir skurdą“ (Partija „Jaunoji Lietuva“, Tautininkų sąjunga)";"65";"12";"77";"0,50";"0,54";"Panerių";11;"JL"
9;"„Drąsos kelias“ politinė partija";"18";"5";"23";"0,15";"0,28";"Panerių";11;"DK"
2;"Tėvynės sąjunga - Lietuvos krikščionys demokratai";"7014";"680";"7694";"35,14";"21,66";"Verkių";12;"TSLKD"
6;"Lietuvos valstiečių ir žaliųjų sąjunga";"2449";"181";"2630";"12,01";"21,54";"Verkių";12;"LVZS"
1;"Lietuvos socialdemokratų partija";"2094";"182";"2276";"10,40";"14,43";"Verkių";12;"LSDP"
7;"Lietuvos Respublikos liberalų sąjūdis";"3336";"318";"3654";"16,69";"9,04";"Verkių";12;"LRLS"
14;"Antikorupcinė N. Puteikio ir K. Krivicko koalicija (Lietuvos centro partija, Lietuvos pensininkų partiją)";"539";"35";"574";"2,62";"6,06";"Verkių";12;"PUTKA"
11;"Lietuvos lenkų rinkimų akcija-Krikščioniškų šeimų sąjunga";"1313";"67";"1380";"6,30";"5,49";"Verkių";12;"LLRA"
5;"Partija Tvarka ir teisingumas";"412";"32";"444";"2,03";"5,33";"Verkių";12;"PTT"
8;"Darbo partija";"456";"33";"489";"2,23";"4,69";"Verkių";12;"DP"
3;"Lietuvos laisvės sąjunga (liberalai)";"1010";"68";"1078";"4,92";"2,14";"Verkių";12;"LLS"
12;"Lietuvos žaliųjų partija";"414";"23";"437";"2,00";"1,94";"Verkių";12;"LZS"
13;"Politinė partija „Lietuvos sąrašas“";"500";"32";"532";"2,43";"1,72";"Verkių";12;"LS"
10;"Lietuvos liaudies partija";"178";"12";"190";"0,87";"1,01";"Verkių";12;"LLP"
4;"S. Buškevičiaus ir Tautininkų koalicija „Prieš korupciją ir skurdą“ (Partija „Jaunoji Lietuva“, Tautininkų sąjunga)";"71";"8";"79";"0,36";"0,54";"Verkių";12;"JL"
9;"„Drąsos kelias“ politinė partija";"21";"4";"25";"0,11";"0,28";"Verkių";12;"DK"
2;"Tėvynės sąjunga - Lietuvos krikščionys demokratai";"6357";"934";"7291";"36,09";"21,66";"Centro-Žaliakalnio";13;"TSLKD"
6;"Lietuvos valstiečių ir žaliųjų sąjunga";"3223";"324";"3547";"17,56";"21,54";"Centro-Žaliakalnio";13;"LVZS"
1;"Lietuvos socialdemokratų partija";"2365";"295";"2660";"13,17";"14,43";"Centro-Žaliakalnio";13;"LSDP"
7;"Lietuvos Respublikos liberalų sąjūdis";"1838";"268";"2106";"10,43";"9,04";"Centro-Žaliakalnio";13;"LRLS"
14;"Antikorupcinė N. Puteikio ir K. Krivicko koalicija (Lietuvos centro partija, Lietuvos pensininkų partiją)";"930";"145";"1075";"5,32";"6,06";"Centro-Žaliakalnio";13;"PUTKA"
11;"Lietuvos lenkų rinkimų akcija-Krikščioniškų šeimų sąjunga";"76";"8";"84";"0,42";"5,49";"Centro-Žaliakalnio";13;"LLRA"
5;"Partija Tvarka ir teisingumas";"511";"70";"581";"2,88";"5,33";"Centro-Žaliakalnio";13;"PTT"
8;"Darbo partija";"419";"55";"474";"2,35";"4,69";"Centro-Žaliakalnio";13;"DP"
3;"Lietuvos laisvės sąjunga (liberalai)";"262";"28";"290";"1,44";"2,14";"Centro-Žaliakalnio";13;"LLS"
12;"Lietuvos žaliųjų partija";"321";"36";"357";"1,77";"1,94";"Centro-Žaliakalnio";13;"LZS"
13;"Politinė partija „Lietuvos sąrašas“";"454";"48";"502";"2,49";"1,72";"Centro-Žaliakalnio";13;"LS"
10;"Lietuvos liaudies partija";"305";"21";"326";"1,61";"1,01";"Centro-Žaliakalnio";13;"LLP"
4;"S. Buškevičiaus ir Tautininkų koalicija „Prieš korupciją ir skurdą“ (Partija „Jaunoji Lietuva“, Tautininkų sąjunga)";"110";"15";"125";"0,62";"0,54";"Centro-Žaliakalnio";13;"JL"
9;"„Drąsos kelias“ politinė partija";"103";"11";"114";"0,56";"0,28";"Centro-Žaliakalnio";13;"DK"
2;"Tėvynės sąjunga - Lietuvos krikščionys demokratai";"4847";"393";"5240";"26,27";"21,66";"Šilainių";14;"TSLKD"
6;"Lietuvos valstiečių ir žaliųjų sąjunga";"5635";"226";"5861";"29,38";"21,54";"Šilainių";14;"LVZS"
1;"Lietuvos socialdemokratų partija";"2049";"122";"2171";"10,88";"14,43";"Šilainių";14;"LSDP"
7;"Lietuvos Respublikos liberalų sąjūdis";"1674";"135";"1809";"9,07";"9,04";"Šilainių";14;"LRLS"
14;"Antikorupcinė N. Puteikio ir K. Krivicko koalicija (Lietuvos centro partija, Lietuvos pensininkų partiją)";"1314";"60";"1374";"6,89";"6,06";"Šilainių";14;"PUTKA"
11;"Lietuvos lenkų rinkimų akcija-Krikščioniškų šeimų sąjunga";"80";"6";"86";"0,43";"5,49";"Šilainių";14;"LLRA"
5;"Partija Tvarka ir teisingumas";"647";"57";"704";"3,53";"5,33";"Šilainių";14;"PTT"
8;"Darbo partija";"468";"38";"506";"2,54";"4,69";"Šilainių";14;"DP"
3;"Lietuvos laisvės sąjunga (liberalai)";"191";"44";"235";"1,18";"2,14";"Šilainių";14;"LLS"
12;"Lietuvos žaliųjų partija";"391";"14";"405";"2,03";"1,94";"Šilainių";14;"LZS"
13;"Politinė partija „Lietuvos sąrašas“";"402";"14";"416";"2,09";"1,72";"Šilainių";14;"LS"
10;"Lietuvos liaudies partija";"241";"12";"253";"1,27";"1,01";"Šilainių";14;"LLP"
4;"S. Buškevičiaus ir Tautininkų koalicija „Prieš korupciją ir skurdą“ (Partija „Jaunoji Lietuva“, Tautininkų sąjunga)";"96";"3";"99";"0,50";"0,54";"Šilainių";14;"JL"
9;"„Drąsos kelias“ politinė partija";"100";"7";"107";"0,54";"0,28";"Šilainių";14;"DK"
2;"Tėvynės sąjunga - Lietuvos krikščionys demokratai";"5028";"492";"5520";"27,44";"21,66";"Kalniečių";15;"TSLKD"
6;"Lietuvos valstiečių ir žaliųjų sąjunga";"4562";"263";"4825";"23,98";"21,54";"Kalniečių";15;"LVZS"
1;"Lietuvos socialdemokratų partija";"2426";"199";"2625";"13,05";"14,43";"Kalniečių";15;"LSDP"
7;"Lietuvos Respublikos liberalų sąjūdis";"1604";"172";"1776";"8,83";"9,04";"Kalniečių";15;"LRLS"
14;"Antikorupcinė N. Puteikio ir K. Krivicko koalicija (Lietuvos centro partija, Lietuvos pensininkų partiją)";"1326";"74";"1400";"6,96";"6,06";"Kalniečių";15;"PUTKA"
11;"Lietuvos lenkų rinkimų akcija-Krikščioniškų šeimų sąjunga";"83";"9";"92";"0,46";"5,49";"Kalniečių";15;"LLRA"
5;"Partija Tvarka ir teisingumas";"635";"36";"671";"3,34";"5,33";"Kalniečių";15;"PTT"
8;"Darbo partija";"477";"45";"522";"2,59";"4,69";"Kalniečių";15;"DP"
3;"Lietuvos laisvės sąjunga (liberalai)";"198";"14";"212";"1,05";"2,14";"Kalniečių";15;"LLS"
12;"Lietuvos žaliųjų partija";"508";"24";"532";"2,64";"1,94";"Kalniečių";15;"LZS"
13;"Politinė partija „Lietuvos sąrašas“";"414";"32";"446";"2,22";"1,72";"Kalniečių";15;"LS"
10;"Lietuvos liaudies partija";"265";"13";"278";"1,38";"1,01";"Kalniečių";15;"LLP"
4;"S. Buškevičiaus ir Tautininkų koalicija „Prieš korupciją ir skurdą“ (Partija „Jaunoji Lietuva“, Tautininkų sąjunga)";"379";"11";"390";"1,94";"0,54";"Kalniečių";15;"JL"
9;"„Drąsos kelias“ politinė partija";"85";"7";"92";"0,46";"0,28";"Kalniečių";15;"DK"
2;"Tėvynės sąjunga - Lietuvos krikščionys demokratai";"4576";"432";"5008";"26,08";"21,66";"Dainavos";16;"TSLKD"
6;"Lietuvos valstiečių ir žaliųjų sąjunga";"4423";"244";"4667";"24,30";"21,54";"Dainavos";16;"LVZS"
1;"Lietuvos socialdemokratų partija";"2385";"178";"2563";"13,34";"14,43";"Dainavos";16;"LSDP"
7;"Lietuvos Respublikos liberalų sąjūdis";"1479";"102";"1581";"8,23";"9,04";"Dainavos";16;"LRLS"
14;"Antikorupcinė N. Puteikio ir K. Krivicko koalicija (Lietuvos centro partija, Lietuvos pensininkų partiją)";"1416";"58";"1474";"7,67";"6,06";"Dainavos";16;"PUTKA"
11;"Lietuvos lenkų rinkimų akcija-Krikščioniškų šeimų sąjunga";"88";"3";"91";"0,47";"5,49";"Dainavos";16;"LLRA"
5;"Partija Tvarka ir teisingumas";"683";"50";"733";"3,82";"5,33";"Dainavos";16;"PTT"
8;"Darbo partija";"554";"51";"605";"3,15";"4,69";"Dainavos";16;"DP"
3;"Lietuvos laisvės sąjunga (liberalai)";"163";"24";"187";"0,97";"2,14";"Dainavos";16;"LLS"
12;"Lietuvos žaliųjų partija";"497";"33";"530";"2,76";"1,94";"Dainavos";16;"LZS"
13;"Politinė partija „Lietuvos sąrašas“";"385";"21";"406";"2,11";"1,72";"Dainavos";16;"LS"
10;"Lietuvos liaudies partija";"200";"12";"212";"1,10";"1,01";"Dainavos";16;"LLP"
4;"S. Buškevičiaus ir Tautininkų koalicija „Prieš korupciją ir skurdą“ (Partija „Jaunoji Lietuva“, Tautininkų sąjunga)";"244";"13";"257";"1,34";"0,54";"Dainavos";16;"JL"
9;"„Drąsos kelias“ politinė partija";"89";"6";"95";"0,49";"0,28";"Dainavos";16;"DK"
2;"Tėvynės sąjunga - Lietuvos krikščionys demokratai";"4423";"391";"4814";"26,58";"21,66";"Petrašiūnų";17;"TSLKD"
6;"Lietuvos valstiečių ir žaliųjų sąjunga";"4331";"224";"4555";"25,15";"21,54";"Petrašiūnų";17;"LVZS"
1;"Lietuvos socialdemokratų partija";"2022";"150";"2172";"11,99";"14,43";"Petrašiūnų";17;"LSDP"
7;"Lietuvos Respublikos liberalų sąjūdis";"1294";"130";"1424";"7,86";"9,04";"Petrašiūnų";17;"LRLS"
14;"Antikorupcinė N. Puteikio ir K. Krivicko koalicija (Lietuvos centro partija, Lietuvos pensininkų partiją)";"1272";"78";"1350";"7,46";"6,06";"Petrašiūnų";17;"PUTKA"
11;"Lietuvos lenkų rinkimų akcija-Krikščioniškų šeimų sąjunga";"104";"2";"106";"0,59";"5,49";"Petrašiūnų";17;"LLRA"
5;"Partija Tvarka ir teisingumas";"680";"67";"747";"4,13";"5,33";"Petrašiūnų";17;"PTT"
8;"Darbo partija";"559";"52";"611";"3,37";"4,69";"Petrašiūnų";17;"DP"
3;"Lietuvos laisvės sąjunga (liberalai)";"203";"24";"227";"1,25";"2,14";"Petrašiūnų";17;"LLS"
12;"Lietuvos žaliųjų partija";"472";"24";"496";"2,74";"1,94";"Petrašiūnų";17;"LZS"
13;"Politinė partija „Lietuvos sąrašas“";"334";"16";"350";"1,93";"1,72";"Petrašiūnų";17;"LS"
10;"Lietuvos liaudies partija";"287";"15";"302";"1,67";"1,01";"Petrašiūnų";17;"LLP"
4;"S. Buškevičiaus ir Tautininkų koalicija „Prieš korupciją ir skurdą“ (Partija „Jaunoji Lietuva“, Tautininkų sąjunga)";"146";"14";"160";"0,88";"0,54";"Petrašiūnų";17;"JL"
9;"„Drąsos kelias“ politinė partija";"97";"6";"103";"0,57";"0,28";"Petrašiūnų";17;"DK"
2;"Tėvynės sąjunga - Lietuvos krikščionys demokratai";"5273";"478";"5751";"29,29";"21,66";"Panemunės";18;"TSLKD"
6;"Lietuvos valstiečių ir žaliųjų sąjunga";"4229";"232";"4461";"22,72";"21,54";"Panemunės";18;"LVZS"
1;"Lietuvos socialdemokratų partija";"2341";"186";"2527";"12,87";"14,43";"Panemunės";18;"LSDP"
7;"Lietuvos Respublikos liberalų sąjūdis";"1510";"126";"1636";"8,33";"9,04";"Panemunės";18;"LRLS"
14;"Antikorupcinė N. Puteikio ir K. Krivicko koalicija (Lietuvos centro partija, Lietuvos pensininkų partiją)";"1284";"66";"1350";"6,88";"6,06";"Panemunės";18;"PUTKA"
11;"Lietuvos lenkų rinkimų akcija-Krikščioniškų šeimų sąjunga";"113";"9";"122";"0,62";"5,49";"Panemunės";18;"LLRA"
5;"Partija Tvarka ir teisingumas";"701";"81";"782";"3,98";"5,33";"Panemunės";18;"PTT"
8;"Darbo partija";"567";"50";"617";"3,14";"4,69";"Panemunės";18;"DP"
3;"Lietuvos laisvės sąjunga (liberalai)";"223";"17";"240";"1,22";"2,14";"Panemunės";18;"LLS"
12;"Lietuvos žaliųjų partija";"511";"17";"528";"2,69";"1,94";"Panemunės";18;"LZS"
13;"Politinė partija „Lietuvos sąrašas“";"386";"23";"409";"2,08";"1,72";"Panemunės";18;"LS"
10;"Lietuvos liaudies partija";"267";"7";"274";"1,40";"1,01";"Panemunės";18;"LLP"
4;"S. Buškevičiaus ir Tautininkų koalicija „Prieš korupciją ir skurdą“ (Partija „Jaunoji Lietuva“, Tautininkų sąjunga)";"112";"11";"123";"0,63";"0,54";"Panemunės";18;"JL"
9;"„Drąsos kelias“ politinė partija";"141";"11";"152";"0,77";"0,28";"Panemunės";18;"DK"
2;"Tėvynės sąjunga - Lietuvos krikščionys demokratai";"5120";"532";"5652";"28,22";"21,66";"Aleksoto-Vilijampolės";19;"TSLKD"
6;"Lietuvos valstiečių ir žaliųjų sąjunga";"4855";"286";"5141";"25,67";"21,54";"Aleksoto-Vilijampolės";19;"LVZS"
1;"Lietuvos socialdemokratų partija";"2296";"174";"2470";"12,33";"14,43";"Aleksoto-Vilijampolės";19;"LSDP"
7;"Lietuvos Respublikos liberalų sąjūdis";"1490";"125";"1615";"8,06";"9,04";"Aleksoto-Vilijampolės";19;"LRLS"
14;"Antikorupcinė N. Puteikio ir K. Krivicko koalicija (Lietuvos centro partija, Lietuvos pensininkų partiją)";"1171";"62";"1233";"6,16";"6,06";"Aleksoto-Vilijampolės";19;"PUTKA"
11;"Lietuvos lenkų rinkimų akcija-Krikščioniškų šeimų sąjunga";"54";"2";"56";"0,28";"5,49";"Aleksoto-Vilijampolės";19;"LLRA"
5;"Partija Tvarka ir teisingumas";"601";"105";"706";"3,52";"5,33";"Aleksoto-Vilijampolės";19;"PTT"
8;"Darbo partija";"458";"49";"507";"2,53";"4,69";"Aleksoto-Vilijampolės";19;"DP"
3;"Lietuvos laisvės sąjunga (liberalai)";"243";"28";"271";"1,35";"2,14";"Aleksoto-Vilijampolės";19;"LLS"
12;"Lietuvos žaliųjų partija";"452";"31";"483";"2,41";"1,94";"Aleksoto-Vilijampolės";19;"LZS"
13;"Politinė partija „Lietuvos sąrašas“";"471";"21";"492";"2,46";"1,72";"Aleksoto-Vilijampolės";19;"LS"
10;"Lietuvos liaudies partija";"270";"18";"288";"1,44";"1,01";"Aleksoto-Vilijampolės";19;"LLP"
4;"S. Buškevičiaus ir Tautininkų koalicija „Prieš korupciją ir skurdą“ (Partija „Jaunoji Lietuva“, Tautininkų sąjunga)";"118";"11";"129";"0,64";"0,54";"Aleksoto-Vilijampolės";19;"JL"
9;"„Drąsos kelias“ politinė partija";"150";"11";"161";"0,80";"0,28";"Aleksoto-Vilijampolės";19;"DK"
2;"Tėvynės sąjunga - Lietuvos krikščionys demokratai";"2613";"302";"2915";"19,98";"21,66";"Baltijos";20;"TSLKD"
6;"Lietuvos valstiečių ir žaliųjų sąjunga";"2307";"137";"2444";"16,75";"21,54";"Baltijos";20;"LVZS"
1;"Lietuvos socialdemokratų partija";"1245";"108";"1353";"9,28";"14,43";"Baltijos";20;"LSDP"
7;"Lietuvos Respublikos liberalų sąjūdis";"1531";"187";"1718";"11,78";"9,04";"Baltijos";20;"LRLS"
14;"Antikorupcinė N. Puteikio ir K. Krivicko koalicija (Lietuvos centro partija, Lietuvos pensininkų partiją)";"1671";"75";"1746";"11,97";"6,06";"Baltijos";20;"PUTKA"
11;"Lietuvos lenkų rinkimų akcija-Krikščioniškų šeimų sąjunga";"1277";"49";"1326";"9,09";"5,49";"Baltijos";20;"LLRA"
5;"Partija Tvarka ir teisingumas";"774";"52";"826";"5,66";"5,33";"Baltijos";20;"PTT"
8;"Darbo partija";"495";"37";"532";"3,65";"4,69";"Baltijos";20;"DP"
3;"Lietuvos laisvės sąjunga (liberalai)";"153";"17";"170";"1,17";"2,14";"Baltijos";20;"LLS"
12;"Lietuvos žaliųjų partija";"197";"24";"221";"1,52";"1,94";"Baltijos";20;"LZS"
13;"Politinė partija „Lietuvos sąrašas“";"226";"7";"233";"1,60";"1,72";"Baltijos";20;"LS"
10;"Lietuvos liaudies partija";"157";"12";"169";"1,16";"1,01";"Baltijos";20;"LLP"
4;"S. Buškevičiaus ir Tautininkų koalicija „Prieš korupciją ir skurdą“ (Partija „Jaunoji Lietuva“, Tautininkų sąjunga)";"104";"6";"110";"0,75";"0,54";"Baltijos";20;"JL"
9;"„Drąsos kelias“ politinė partija";"32";"2";"34";"0,23";"0,28";"Baltijos";20;"DK"
2;"Tėvynės sąjunga - Lietuvos krikščionys demokratai";"2211";"259";"2470";"17,32";"21,66";"Marių";21;"TSLKD"
6;"Lietuvos valstiečių ir žaliųjų sąjunga";"2287";"124";"2411";"16,91";"21,54";"Marių";21;"LVZS"
1;"Lietuvos socialdemokratų partija";"1260";"79";"1339";"9,39";"14,43";"Marių";21;"LSDP"
7;"Lietuvos Respublikos liberalų sąjūdis";"1687";"179";"1866";"13,09";"9,04";"Marių";21;"LRLS"
14;"Antikorupcinė N. Puteikio ir K. Krivicko koalicija (Lietuvos centro partija, Lietuvos pensininkų partiją)";"1733";"80";"1813";"12,71";"6,06";"Marių";21;"PUTKA"
11;"Lietuvos lenkų rinkimų akcija-Krikščioniškų šeimų sąjunga";"1316";"43";"1359";"9,53";"5,49";"Marių";21;"LLRA"
5;"Partija Tvarka ir teisingumas";"729";"47";"776";"5,44";"5,33";"Marių";21;"PTT"
8;"Darbo partija";"464";"46";"510";"3,58";"4,69";"Marių";21;"DP"
3;"Lietuvos laisvės sąjunga (liberalai)";"154";"11";"165";"1,16";"2,14";"Marių";21;"LLS"
12;"Lietuvos žaliųjų partija";"199";"11";"210";"1,47";"1,94";"Marių";21;"LZS"
13;"Politinė partija „Lietuvos sąrašas“";"367";"24";"391";"2,74";"1,72";"Marių";21;"LS"
10;"Lietuvos liaudies partija";"143";"5";"148";"1,04";"1,01";"Marių";21;"LLP"
4;"S. Buškevičiaus ir Tautininkų koalicija „Prieš korupciją ir skurdą“ (Partija „Jaunoji Lietuva“, Tautininkų sąjunga)";"76";"5";"81";"0,57";"0,54";"Marių";21;"JL"
9;"„Drąsos kelias“ politinė partija";"40";"6";"46";"0,32";"0,28";"Marių";21;"DK"
2;"Tėvynės sąjunga - Lietuvos krikščionys demokratai";"2613";"649";"3262";"20,27";"21,66";"Pajūrio";22;"TSLKD"
6;"Lietuvos valstiečių ir žaliųjų sąjunga";"2243";"244";"2487";"15,46";"21,54";"Pajūrio";22;"LVZS"
1;"Lietuvos socialdemokratų partija";"1564";"238";"1802";"11,20";"14,43";"Pajūrio";22;"LSDP"
7;"Lietuvos Respublikos liberalų sąjūdis";"2060";"411";"2471";"15,36";"9,04";"Pajūrio";22;"LRLS"
14;"Antikorupcinė N. Puteikio ir K. Krivicko koalicija (Lietuvos centro partija, Lietuvos pensininkų partiją)";"1562";"123";"1685";"10,47";"6,06";"Pajūrio";22;"PUTKA"
11;"Lietuvos lenkų rinkimų akcija-Krikščioniškų šeimų sąjunga";"1175";"47";"1222";"7,59";"5,49";"Pajūrio";22;"LLRA"
5;"Partija Tvarka ir teisingumas";"734";"81";"815";"5,06";"5,33";"Pajūrio";22;"PTT"
8;"Darbo partija";"483";"46";"529";"3,29";"4,69";"Pajūrio";22;"DP"
3;"Lietuvos laisvės sąjunga (liberalai)";"137";"30";"167";"1,04";"2,14";"Pajūrio";22;"LLS"
12;"Lietuvos žaliųjų partija";"286";"21";"307";"1,91";"1,94";"Pajūrio";22;"LZS"
13;"Politinė partija „Lietuvos sąrašas“";"291";"22";"313";"1,95";"1,72";"Pajūrio";22;"LS"
10;"Lietuvos liaudies partija";"173";"17";"190";"1,18";"1,01";"Pajūrio";22;"LLP"
4;"S. Buškevičiaus ir Tautininkų koalicija „Prieš korupciją ir skurdą“ (Partija „Jaunoji Lietuva“, Tautininkų sąjunga)";"74";"7";"81";"0,50";"0,54";"Pajūrio";22;"JL"
9;"„Drąsos kelias“ politinė partija";"42";"7";"49";"0,30";"0,28";"Pajūrio";22;"DK"
2;"Tėvynės sąjunga - Lietuvos krikščionys demokratai";"3761";"631";"4392";"24,67";"21,66";"Danės";23;"TSLKD"
6;"Lietuvos valstiečių ir žaliųjų sąjunga";"2501";"232";"2733";"15,35";"21,54";"Danės";23;"LVZS"
1;"Lietuvos socialdemokratų partija";"1725";"198";"1923";"10,80";"14,43";"Danės";23;"LSDP"
7;"Lietuvos Respublikos liberalų sąjūdis";"2537";"382";"2919";"16,39";"9,04";"Danės";23;"LRLS"
14;"Antikorupcinė N. Puteikio ir K. Krivicko koalicija (Lietuvos centro partija, Lietuvos pensininkų partiją)";"1958";"160";"2118";"11,89";"6,06";"Danės";23;"PUTKA"
11;"Lietuvos lenkų rinkimų akcija-Krikščioniškų šeimų sąjunga";"694";"29";"723";"4,06";"5,49";"Danės";23;"LLRA"
5;"Partija Tvarka ir teisingumas";"641";"86";"727";"4,08";"5,33";"Danės";23;"PTT"
8;"Darbo partija";"384";"46";"430";"2,41";"4,69";"Danės";23;"DP"
3;"Lietuvos laisvės sąjunga (liberalai)";"240";"31";"271";"1,52";"2,14";"Danės";23;"LLS"
12;"Lietuvos žaliųjų partija";"251";"26";"277";"1,56";"1,94";"Danės";23;"LZS"
13;"Politinė partija „Lietuvos sąrašas“";"303";"30";"333";"1,87";"1,72";"Danės";23;"LS"
10;"Lietuvos liaudies partija";"146";"21";"167";"0,94";"1,01";"Danės";23;"LLP"
4;"S. Buškevičiaus ir Tautininkų koalicija „Prieš korupciją ir skurdą“ (Partija „Jaunoji Lietuva“, Tautininkų sąjunga)";"60";"6";"66";"0,37";"0,54";"Danės";23;"JL"
9;"„Drąsos kelias“ politinė partija";"39";"4";"43";"0,24";"0,28";"Danės";23;"DK"
2;"Tėvynės sąjunga - Lietuvos krikščionys demokratai";"2532";"397";"2929";"16,56";"21,66";"Saulės";24;"TSLKD"
6;"Lietuvos valstiečių ir žaliųjų sąjunga";"5394";"440";"5834";"32,99";"21,54";"Saulės";24;"LVZS"
1;"Lietuvos socialdemokratų partija";"2607";"243";"2850";"16,11";"14,43";"Saulės";24;"LSDP"
7;"Lietuvos Respublikos liberalų sąjūdis";"1159";"194";"1353";"7,65";"9,04";"Saulės";24;"LRLS"
14;"Antikorupcinė N. Puteikio ir K. Krivicko koalicija (Lietuvos centro partija, Lietuvos pensininkų partiją)";"1228";"111";"1339";"7,57";"6,06";"Saulės";24;"PUTKA"
11;"Lietuvos lenkų rinkimų akcija-Krikščioniškų šeimų sąjunga";"101";"8";"109";"0,62";"5,49";"Saulės";24;"LLRA"
5;"Partija Tvarka ir teisingumas";"713";"98";"811";"4,59";"5,33";"Saulės";24;"PTT"
8;"Darbo partija";"490";"133";"623";"3,52";"4,69";"Saulės";24;"DP"
3;"Lietuvos laisvės sąjunga (liberalai)";"148";"19";"167";"0,94";"2,14";"Saulės";24;"LLS"
12;"Lietuvos žaliųjų partija";"307";"35";"342";"1,93";"1,94";"Saulės";24;"LZS"
13;"Politinė partija „Lietuvos sąrašas“";"238";"26";"264";"1,49";"1,72";"Saulės";24;"LS"
10;"Lietuvos liaudies partija";"189";"20";"209";"1,18";"1,01";"Saulės";24;"LLP"
4;"S. Buškevičiaus ir Tautininkų koalicija „Prieš korupciją ir skurdą“ (Partija „Jaunoji Lietuva“, Tautininkų sąjunga)";"77";"13";"90";"0,51";"0,54";"Saulės";24;"JL"
9;"„Drąsos kelias“ politinė partija";"53";"4";"57";"0,32";"0,28";"Saulės";24;"DK"
2;"Tėvynės sąjunga - Lietuvos krikščionys demokratai";"2895";"530";"3425";"19,34";"21,66";"Aušros";25;"TSLKD"
6;"Lietuvos valstiečių ir žaliųjų sąjunga";"5017";"397";"5414";"30,57";"21,54";"Aušros";25;"LVZS"
1;"Lietuvos socialdemokratų partija";"2491";"289";"2780";"15,69";"14,43";"Aušros";25;"LSDP"
7;"Lietuvos Respublikos liberalų sąjūdis";"1338";"225";"1563";"8,82";"9,04";"Aušros";25;"LRLS"
14;"Antikorupcinė N. Puteikio ir K. Krivicko koalicija (Lietuvos centro partija, Lietuvos pensininkų partiją)";"1234";"112";"1346";"7,60";"6,06";"Aušros";25;"PUTKA"
11;"Lietuvos lenkų rinkimų akcija-Krikščioniškų šeimų sąjunga";"71";"3";"74";"0,42";"5,49";"Aušros";25;"LLRA"
5;"Partija Tvarka ir teisingumas";"594";"71";"665";"3,75";"5,33";"Aušros";25;"PTT"
8;"Darbo partija";"427";"75";"502";"2,83";"4,69";"Aušros";25;"DP"
3;"Lietuvos laisvės sąjunga (liberalai)";"179";"35";"214";"1,21";"2,14";"Aušros";25;"LLS"
12;"Lietuvos žaliųjų partija";"328";"57";"385";"2,17";"1,94";"Aušros";25;"LZS"
13;"Politinė partija „Lietuvos sąrašas“";"244";"23";"267";"1,51";"1,72";"Aušros";25;"LS"
10;"Lietuvos liaudies partija";"214";"31";"245";"1,38";"1,01";"Aušros";25;"LLP"
4;"S. Buškevičiaus ir Tautininkų koalicija „Prieš korupciją ir skurdą“ (Partija „Jaunoji Lietuva“, Tautininkų sąjunga)";"72";"9";"81";"0,46";"0,54";"Aušros";25;"JL"
9;"„Drąsos kelias“ politinė partija";"36";"0";"36";"0,20";"0,28";"Aušros";25;"DK"
2;"Tėvynės sąjunga - Lietuvos krikščionys demokratai";"3999";"644";"4643";"26,07";"21,66";"Nevėžio";26;"TSLKD"
6;"Lietuvos valstiečių ir žaliųjų sąjunga";"4322";"431";"4753";"26,68";"21,54";"Nevėžio";26;"LVZS"
1;"Lietuvos socialdemokratų partija";"2169";"337";"2506";"14,07";"14,43";"Nevėžio";26;"LSDP"
7;"Lietuvos Respublikos liberalų sąjūdis";"1108";"187";"1295";"7,27";"9,04";"Nevėžio";26;"LRLS"
14;"Antikorupcinė N. Puteikio ir K. Krivicko koalicija (Lietuvos centro partija, Lietuvos pensininkų partiją)";"977";"130";"1107";"6,21";"6,06";"Nevėžio";26;"PUTKA"
11;"Lietuvos lenkų rinkimų akcija-Krikščioniškų šeimų sąjunga";"39";"4";"43";"0,24";"5,49";"Nevėžio";26;"LLRA"
5;"Partija Tvarka ir teisingumas";"640";"77";"717";"4,03";"5,33";"Nevėžio";26;"PTT"
8;"Darbo partija";"470";"95";"565";"3,17";"4,69";"Nevėžio";26;"DP"
3;"Lietuvos laisvės sąjunga (liberalai)";"229";"55";"284";"1,59";"2,14";"Nevėžio";26;"LLS"
12;"Lietuvos žaliųjų partija";"274";"56";"330";"1,85";"1,94";"Nevėžio";26;"LZS"
13;"Politinė partija „Lietuvos sąrašas“";"271";"28";"299";"1,68";"1,72";"Nevėžio";26;"LS"
10;"Lietuvos liaudies partija";"228";"17";"245";"1,38";"1,01";"Nevėžio";26;"LLP"
4;"S. Buškevičiaus ir Tautininkų koalicija „Prieš korupciją ir skurdą“ (Partija „Jaunoji Lietuva“, Tautininkų sąjunga)";"96";"12";"108";"0,61";"0,54";"Nevėžio";26;"JL"
9;"„Drąsos kelias“ politinė partija";"36";"8";"44";"0,25";"0,28";"Nevėžio";26;"DK"
2;"Tėvynės sąjunga - Lietuvos krikščionys demokratai";"3758";"556";"4314";"22,52";"21,66";"Vakarinė";27;"TSLKD"
6;"Lietuvos valstiečių ir žaliųjų sąjunga";"5253";"419";"5672";"29,61";"21,54";"Vakarinė";27;"LVZS"
1;"Lietuvos socialdemokratų partija";"2537";"208";"2745";"14,33";"14,43";"Vakarinė";27;"LSDP"
7;"Lietuvos Respublikos liberalų sąjūdis";"1263";"220";"1483";"7,74";"9,04";"Vakarinė";27;"LRLS"
14;"Antikorupcinė N. Puteikio ir K. Krivicko koalicija (Lietuvos centro partija, Lietuvos pensininkų partiją)";"1452";"72";"1524";"7,96";"6,06";"Vakarinė";27;"PUTKA"
11;"Lietuvos lenkų rinkimų akcija-Krikščioniškų šeimų sąjunga";"62";"2";"64";"0,33";"5,49";"Vakarinė";27;"LLRA"
5;"Partija Tvarka ir teisingumas";"512";"40";"552";"2,88";"5,33";"Vakarinė";27;"PTT"
8;"Darbo partija";"523";"47";"570";"2,98";"4,69";"Vakarinė";27;"DP"
3;"Lietuvos laisvės sąjunga (liberalai)";"216";"30";"246";"1,28";"2,14";"Vakarinė";27;"LLS"
12;"Lietuvos žaliųjų partija";"349";"35";"384";"2,00";"1,94";"Vakarinė";27;"LZS"
13;"Politinė partija „Lietuvos sąrašas“";"339";"24";"363";"1,89";"1,72";"Vakarinė";27;"LS"
10;"Lietuvos liaudies partija";"212";"19";"231";"1,21";"1,01";"Vakarinė";27;"LLP"
4;"S. Buškevičiaus ir Tautininkų koalicija „Prieš korupciją ir skurdą“ (Partija „Jaunoji Lietuva“, Tautininkų sąjunga)";"86";"4";"90";"0,47";"0,54";"Vakarinė";27;"JL"
9;"„Drąsos kelias“ politinė partija";"32";"2";"34";"0,18";"0,28";"Vakarinė";27;"DK"
2;"Tėvynės sąjunga - Lietuvos krikščionys demokratai";"3599";"595";"4194";"22,75";"21,66";"Aukštaitijos";28;"TSLKD"
6;"Lietuvos valstiečių ir žaliųjų sąjunga";"5122";"607";"5729";"31,08";"21,54";"Aukštaitijos";28;"LVZS"
1;"Lietuvos socialdemokratų partija";"2603";"335";"2938";"15,94";"14,43";"Aukštaitijos";28;"LSDP"
7;"Lietuvos Respublikos liberalų sąjūdis";"1002";"162";"1164";"6,31";"9,04";"Aukštaitijos";28;"LRLS"
14;"Antikorupcinė N. Puteikio ir K. Krivicko koalicija (Lietuvos centro partija, Lietuvos pensininkų partiją)";"975";"103";"1078";"5,85";"6,06";"Aukštaitijos";28;"PUTKA"
11;"Lietuvos lenkų rinkimų akcija-Krikščioniškų šeimų sąjunga";"39";"3";"42";"0,23";"5,49";"Aukštaitijos";28;"LLRA"
5;"Partija Tvarka ir teisingumas";"606";"104";"710";"3,85";"5,33";"Aukštaitijos";28;"PTT"
8;"Darbo partija";"582";"97";"679";"3,68";"4,69";"Aukštaitijos";28;"DP"
3;"Lietuvos laisvės sąjunga (liberalai)";"184";"36";"220";"1,19";"2,14";"Aukštaitijos";28;"LLS"
12;"Lietuvos žaliųjų partija";"253";"38";"291";"1,58";"1,94";"Aukštaitijos";28;"LZS"
13;"Politinė partija „Lietuvos sąrašas“";"248";"22";"270";"1,46";"1,72";"Aukštaitijos";28;"LS"
10;"Lietuvos liaudies partija";"210";"23";"233";"1,26";"1,01";"Aukštaitijos";28;"LLP"
4;"S. Buškevičiaus ir Tautininkų koalicija „Prieš korupciją ir skurdą“ (Partija „Jaunoji Lietuva“, Tautininkų sąjunga)";"92";"9";"101";"0,55";"0,54";"Aukštaitijos";28;"JL"
9;"„Drąsos kelias“ politinė partija";"30";"2";"32";"0,17";"0,28";"Aukštaitijos";28;"DK"
2;"Tėvynės sąjunga - Lietuvos krikščionys demokratai";"3059";"643";"3702";"20,90";"21,66";"Marijampolės";29;"TSLKD"
6;"Lietuvos valstiečių ir žaliųjų sąjunga";"4942";"491";"5433";"30,68";"21,54";"Marijampolės";29;"LVZS"
1;"Lietuvos socialdemokratų partija";"3045";"478";"3523";"19,89";"14,43";"Marijampolės";29;"LSDP"
7;"Lietuvos Respublikos liberalų sąjūdis";"763";"168";"931";"5,26";"9,04";"Marijampolės";29;"LRLS"
14;"Antikorupcinė N. Puteikio ir K. Krivicko koalicija (Lietuvos centro partija, Lietuvos pensininkų partiją)";"1141";"170";"1311";"7,40";"6,06";"Marijampolės";29;"PUTKA"
11;"Lietuvos lenkų rinkimų akcija-Krikščioniškų šeimų sąjunga";"8";"5";"13";"0,07";"5,49";"Marijampolės";29;"LLRA"
5;"Partija Tvarka ir teisingumas";"531";"98";"629";"3,55";"5,33";"Marijampolės";29;"PTT"
8;"Darbo partija";"400";"106";"506";"2,86";"4,69";"Marijampolės";29;"DP"
3;"Lietuvos laisvės sąjunga (liberalai)";"140";"28";"168";"0,95";"2,14";"Marijampolės";29;"LLS"
12;"Lietuvos žaliųjų partija";"291";"36";"327";"1,85";"1,94";"Marijampolės";29;"LZS"
13;"Politinė partija „Lietuvos sąrašas“";"163";"31";"194";"1,10";"1,72";"Marijampolės";29;"LS"
10;"Lietuvos liaudies partija";"130";"23";"153";"0,86";"1,01";"Marijampolės";29;"LLP"
4;"S. Buškevičiaus ir Tautininkų koalicija „Prieš korupciją ir skurdą“ (Partija „Jaunoji Lietuva“, Tautininkų sąjunga)";"65";"9";"74";"0,42";"0,54";"Marijampolės";29;"JL"
9;"„Drąsos kelias“ politinė partija";"40";"15";"55";"0,31";"0,28";"Marijampolės";29;"DK"
2;"Tėvynės sąjunga - Lietuvos krikščionys demokratai";"3055";"467";"3522";"20,30";"21,66";"Alytaus";30;"TSLKD"
6;"Lietuvos valstiečių ir žaliųjų sąjunga";"3878";"256";"4134";"23,83";"21,54";"Alytaus";30;"LVZS"
1;"Lietuvos socialdemokratų partija";"2556";"241";"2797";"16,12";"14,43";"Alytaus";30;"LSDP"
7;"Lietuvos Respublikos liberalų sąjūdis";"1040";"194";"1234";"7,11";"9,04";"Alytaus";30;"LRLS"
14;"Antikorupcinė N. Puteikio ir K. Krivicko koalicija (Lietuvos centro partija, Lietuvos pensininkų partiją)";"1533";"184";"1717";"9,90";"6,06";"Alytaus";30;"PUTKA"
11;"Lietuvos lenkų rinkimų akcija-Krikščioniškų šeimų sąjunga";"36";"5";"41";"0,24";"5,49";"Alytaus";30;"LLRA"
5;"Partija Tvarka ir teisingumas";"728";"81";"809";"4,66";"5,33";"Alytaus";30;"PTT"
8;"Darbo partija";"773";"133";"906";"5,22";"4,69";"Alytaus";30;"DP"
3;"Lietuvos laisvės sąjunga (liberalai)";"177";"31";"208";"1,20";"2,14";"Alytaus";30;"LLS"
12;"Lietuvos žaliųjų partija";"442";"31";"473";"2,73";"1,94";"Alytaus";30;"LZS"
13;"Politinė partija „Lietuvos sąrašas“";"294";"24";"318";"1,83";"1,72";"Alytaus";30;"LS"
10;"Lietuvos liaudies partija";"120";"20";"140";"0,81";"1,01";"Alytaus";30;"LLP"
4;"S. Buškevičiaus ir Tautininkų koalicija „Prieš korupciją ir skurdą“ (Partija „Jaunoji Lietuva“, Tautininkų sąjunga)";"85";"9";"94";"0,54";"0,54";"Alytaus";30;"JL"
9;"„Drąsos kelias“ politinė partija";"43";"8";"51";"0,29";"0,28";"Alytaus";30;"DK"
2;"Tėvynės sąjunga - Lietuvos krikščionys demokratai";"2920";"595";"3515";"18,63";"21,66";"Gargždų";31;"TSLKD"
6;"Lietuvos valstiečių ir žaliųjų sąjunga";"3838";"482";"4320";"22,90";"21,54";"Gargždų";31;"LVZS"
1;"Lietuvos socialdemokratų partija";"1633";"287";"1920";"10,18";"14,43";"Gargždų";31;"LSDP"
7;"Lietuvos Respublikos liberalų sąjūdis";"1873";"270";"2143";"11,36";"9,04";"Gargždų";31;"LRLS"
14;"Antikorupcinė N. Puteikio ir K. Krivicko koalicija (Lietuvos centro partija, Lietuvos pensininkų partiją)";"1402";"135";"1537";"8,15";"6,06";"Gargždų";31;"PUTKA"
11;"Lietuvos lenkų rinkimų akcija-Krikščioniškų šeimų sąjunga";"70";"13";"83";"0,44";"5,49";"Gargždų";31;"LLRA"
5;"Partija Tvarka ir teisingumas";"2267";"554";"2821";"14,95";"5,33";"Gargždų";31;"PTT"
8;"Darbo partija";"400";"78";"478";"2,53";"4,69";"Gargždų";31;"DP"
3;"Lietuvos laisvės sąjunga (liberalai)";"129";"36";"165";"0,87";"2,14";"Gargždų";31;"LLS"
12;"Lietuvos žaliųjų partija";"339";"32";"371";"1,97";"1,94";"Gargždų";31;"LZS"
13;"Politinė partija „Lietuvos sąrašas“";"244";"26";"270";"1,43";"1,72";"Gargždų";31;"LS"
10;"Lietuvos liaudies partija";"187";"13";"200";"1,06";"1,01";"Gargždų";31;"LLP"
4;"S. Buškevičiaus ir Tautininkų koalicija „Prieš korupciją ir skurdą“ (Partija „Jaunoji Lietuva“, Tautininkų sąjunga)";"87";"18";"105";"0,56";"0,54";"Gargždų";31;"JL"
9;"„Drąsos kelias“ politinė partija";"27";"4";"31";"0,16";"0,28";"Gargždų";31;"DK"
2;"Tėvynės sąjunga - Lietuvos krikščionys demokratai";"2276";"446";"2722";"18,11";"21,66";"Šilutės";32;"TSLKD"
6;"Lietuvos valstiečių ir žaliųjų sąjunga";"3210";"471";"3681";"24,49";"21,54";"Šilutės";32;"LVZS"
1;"Lietuvos socialdemokratų partija";"1644";"285";"1929";"12,83";"14,43";"Šilutės";32;"LSDP"
7;"Lietuvos Respublikos liberalų sąjūdis";"972";"170";"1142";"7,60";"9,04";"Šilutės";32;"LRLS"
14;"Antikorupcinė N. Puteikio ir K. Krivicko koalicija (Lietuvos centro partija, Lietuvos pensininkų partiją)";"987";"140";"1127";"7,50";"6,06";"Šilutės";32;"PUTKA"
11;"Lietuvos lenkų rinkimų akcija-Krikščioniškų šeimų sąjunga";"20";"3";"23";"0,15";"5,49";"Šilutės";32;"LLRA"
5;"Partija Tvarka ir teisingumas";"1746";"307";"2053";"13,66";"5,33";"Šilutės";32;"PTT"
8;"Darbo partija";"365";"79";"444";"2,95";"4,69";"Šilutės";32;"DP"
3;"Lietuvos laisvės sąjunga (liberalai)";"257";"68";"325";"2,16";"2,14";"Šilutės";32;"LLS"
12;"Lietuvos žaliųjų partija";"232";"33";"265";"1,76";"1,94";"Šilutės";32;"LZS"
13;"Politinė partija „Lietuvos sąrašas“";"121";"14";"135";"0,90";"1,72";"Šilutės";32;"LS"
10;"Lietuvos liaudies partija";"95";"16";"111";"0,74";"1,01";"Šilutės";32;"LLP"
4;"S. Buškevičiaus ir Tautininkų koalicija „Prieš korupciją ir skurdą“ (Partija „Jaunoji Lietuva“, Tautininkų sąjunga)";"69";"9";"78";"0,52";"0,54";"Šilutės";32;"JL"
9;"„Drąsos kelias“ politinė partija";"30";"4";"34";"0,23";"0,28";"Šilutės";32;"DK"
2;"Tėvynės sąjunga - Lietuvos krikščionys demokratai";"2649";"796";"3445";"20,40";"21,66";"Pietų Žemaitijos";33;"TSLKD"
6;"Lietuvos valstiečių ir žaliųjų sąjunga";"2759";"414";"3173";"18,79";"21,54";"Pietų Žemaitijos";33;"LVZS"
1;"Lietuvos socialdemokratų partija";"1893";"433";"2326";"13,77";"14,43";"Pietų Žemaitijos";33;"LSDP"
7;"Lietuvos Respublikos liberalų sąjūdis";"548";"181";"729";"4,32";"9,04";"Pietų Žemaitijos";33;"LRLS"
14;"Antikorupcinė N. Puteikio ir K. Krivicko koalicija (Lietuvos centro partija, Lietuvos pensininkų partiją)";"709";"143";"852";"5,04";"6,06";"Pietų Žemaitijos";33;"PUTKA"
11;"Lietuvos lenkų rinkimų akcija-Krikščioniškų šeimų sąjunga";"13";"7";"20";"0,12";"5,49";"Pietų Žemaitijos";33;"LLRA"
5;"Partija Tvarka ir teisingumas";"3010";"655";"3665";"21,70";"5,33";"Pietų Žemaitijos";33;"PTT"
8;"Darbo partija";"515";"151";"666";"3,94";"4,69";"Pietų Žemaitijos";33;"DP"
3;"Lietuvos laisvės sąjunga (liberalai)";"354";"82";"436";"2,58";"2,14";"Pietų Žemaitijos";33;"LLS"
12;"Lietuvos žaliųjų partija";"189";"29";"218";"1,29";"1,94";"Pietų Žemaitijos";33;"LZS"
13;"Politinė partija „Lietuvos sąrašas“";"98";"20";"118";"0,70";"1,72";"Pietų Žemaitijos";33;"LS"
10;"Lietuvos liaudies partija";"89";"21";"110";"0,65";"1,01";"Pietų Žemaitijos";33;"LLP"
4;"S. Buškevičiaus ir Tautininkų koalicija „Prieš korupciją ir skurdą“ (Partija „Jaunoji Lietuva“, Tautininkų sąjunga)";"59";"27";"86";"0,51";"0,54";"Pietų Žemaitijos";33;"JL"
9;"„Drąsos kelias“ politinė partija";"15";"8";"23";"0,14";"0,28";"Pietų Žemaitijos";33;"DK"
2;"Tėvynės sąjunga - Lietuvos krikščionys demokratai";"2376";"618";"2994";"16,98";"21,66";"Tauragės";34;"TSLKD"
6;"Lietuvos valstiečių ir žaliųjų sąjunga";"3623";"550";"4173";"23,67";"21,54";"Tauragės";34;"LVZS"
1;"Lietuvos socialdemokratų partija";"3848";"801";"4649";"26,37";"14,43";"Tauragės";34;"LSDP"
7;"Lietuvos Respublikos liberalų sąjūdis";"1458";"271";"1729";"9,81";"9,04";"Tauragės";34;"LRLS"
14;"Antikorupcinė N. Puteikio ir K. Krivicko koalicija (Lietuvos centro partija, Lietuvos pensininkų partiją)";"940";"121";"1061";"6,02";"6,06";"Tauragės";34;"PUTKA"
11;"Lietuvos lenkų rinkimų akcija-Krikščioniškų šeimų sąjunga";"20";"8";"28";"0,16";"5,49";"Tauragės";34;"LLRA"
5;"Partija Tvarka ir teisingumas";"748";"174";"922";"5,23";"5,33";"Tauragės";34;"PTT"
8;"Darbo partija";"318";"87";"405";"2,30";"4,69";"Tauragės";34;"DP"
3;"Lietuvos laisvės sąjunga (liberalai)";"97";"31";"128";"0,73";"2,14";"Tauragės";34;"LLS"
12;"Lietuvos žaliųjų partija";"213";"50";"263";"1,49";"1,94";"Tauragės";34;"LZS"
13;"Politinė partija „Lietuvos sąrašas“";"144";"32";"176";"1,00";"1,72";"Tauragės";34;"LS"
10;"Lietuvos liaudies partija";"119";"35";"154";"0,87";"1,01";"Tauragės";34;"LLP"
4;"S. Buškevičiaus ir Tautininkų koalicija „Prieš korupciją ir skurdą“ (Partija „Jaunoji Lietuva“, Tautininkų sąjunga)";"46";"15";"61";"0,35";"0,54";"Tauragės";34;"JL"
9;"„Drąsos kelias“ politinė partija";"30";"6";"36";"0,20";"0,28";"Tauragės";34;"DK"
2;"Tėvynės sąjunga - Lietuvos krikščionys demokratai";"2422";"582";"3004";"19,48";"21,66";"Plungės";35;"TSLKD"
6;"Lietuvos valstiečių ir žaliųjų sąjunga";"3799";"442";"4241";"27,51";"21,54";"Plungės";35;"LVZS"
1;"Lietuvos socialdemokratų partija";"1737";"300";"2037";"13,21";"14,43";"Plungės";35;"LSDP"
7;"Lietuvos Respublikos liberalų sąjūdis";"1422";"240";"1662";"10,78";"9,04";"Plungės";35;"LRLS"
14;"Antikorupcinė N. Puteikio ir K. Krivicko koalicija (Lietuvos centro partija, Lietuvos pensininkų partiją)";"1148";"113";"1261";"8,18";"6,06";"Plungės";35;"PUTKA"
11;"Lietuvos lenkų rinkimų akcija-Krikščioniškų šeimų sąjunga";"13";"4";"17";"0,11";"5,49";"Plungės";35;"LLRA"
5;"Partija Tvarka ir teisingumas";"768";"164";"932";"6,05";"5,33";"Plungės";35;"PTT"
8;"Darbo partija";"458";"96";"554";"3,59";"4,69";"Plungės";35;"DP"
3;"Lietuvos laisvės sąjunga (liberalai)";"182";"29";"211";"1,37";"2,14";"Plungės";35;"LLS"
12;"Lietuvos žaliųjų partija";"228";"38";"266";"1,73";"1,94";"Plungės";35;"LZS"
13;"Politinė partija „Lietuvos sąrašas“";"190";"27";"217";"1,41";"1,72";"Plungės";35;"LS"
10;"Lietuvos liaudies partija";"130";"15";"145";"0,94";"1,01";"Plungės";35;"LLP"
4;"S. Buškevičiaus ir Tautininkų koalicija „Prieš korupciją ir skurdą“ (Partija „Jaunoji Lietuva“, Tautininkų sąjunga)";"56";"11";"67";"0,43";"0,54";"Plungės";35;"JL"
9;"„Drąsos kelias“ politinė partija";"48";"8";"56";"0,36";"0,28";"Plungės";35;"DK"
2;"Tėvynės sąjunga - Lietuvos krikščionys demokratai";"3266";"710";"3976";"24,39";"21,66";"Kretingos-Palangos";36;"TSLKD"
6;"Lietuvos valstiečių ir žaliųjų sąjunga";"2781";"355";"3136";"19,24";"21,54";"Kretingos-Palangos";36;"LVZS"
1;"Lietuvos socialdemokratų partija";"2457";"411";"2868";"17,60";"14,43";"Kretingos-Palangos";36;"LSDP"
7;"Lietuvos Respublikos liberalų sąjūdis";"1311";"292";"1603";"9,83";"9,04";"Kretingos-Palangos";36;"LRLS"
14;"Antikorupcinė N. Puteikio ir K. Krivicko koalicija (Lietuvos centro partija, Lietuvos pensininkų partiją)";"1422";"169";"1591";"9,76";"6,06";"Kretingos-Palangos";36;"PUTKA"
11;"Lietuvos lenkų rinkimų akcija-Krikščioniškų šeimų sąjunga";"45";"2";"47";"0,29";"5,49";"Kretingos-Palangos";36;"LLRA"
5;"Partija Tvarka ir teisingumas";"571";"88";"659";"4,04";"5,33";"Kretingos-Palangos";36;"PTT"
8;"Darbo partija";"440";"94";"534";"3,28";"4,69";"Kretingos-Palangos";36;"DP"
3;"Lietuvos laisvės sąjunga (liberalai)";"156";"20";"176";"1,08";"2,14";"Kretingos-Palangos";36;"LLS"
12;"Lietuvos žaliųjų partija";"274";"43";"317";"1,94";"1,94";"Kretingos-Palangos";36;"LZS"
13;"Politinė partija „Lietuvos sąrašas“";"242";"32";"274";"1,68";"1,72";"Kretingos-Palangos";36;"LS"
10;"Lietuvos liaudies partija";"172";"19";"191";"1,17";"1,01";"Kretingos-Palangos";36;"LLP"
4;"S. Buškevičiaus ir Tautininkų koalicija „Prieš korupciją ir skurdą“ (Partija „Jaunoji Lietuva“, Tautininkų sąjunga)";"68";"4";"72";"0,44";"0,54";"Kretingos-Palangos";36;"JL"
9;"„Drąsos kelias“ politinė partija";"27";"4";"31";"0,19";"0,28";"Kretingos-Palangos";36;"DK"
2;"Tėvynės sąjunga - Lietuvos krikščionys demokratai";"2127";"635";"2762";"19,08";"21,66";"Kuršo";37;"TSLKD"
6;"Lietuvos valstiečių ir žaliųjų sąjunga";"2989";"529";"3518";"24,30";"21,54";"Kuršo";37;"LVZS"
1;"Lietuvos socialdemokratų partija";"1496";"394";"1890";"13,05";"14,43";"Kuršo";37;"LSDP"
7;"Lietuvos Respublikos liberalų sąjūdis";"771";"183";"954";"6,59";"9,04";"Kuršo";37;"LRLS"
14;"Antikorupcinė N. Puteikio ir K. Krivicko koalicija (Lietuvos centro partija, Lietuvos pensininkų partiją)";"1192";"188";"1380";"9,53";"6,06";"Kuršo";37;"PUTKA"
11;"Lietuvos lenkų rinkimų akcija-Krikščioniškų šeimų sąjunga";"20";"5";"25";"0,17";"5,49";"Kuršo";37;"LLRA"
5;"Partija Tvarka ir teisingumas";"1169";"299";"1468";"10,14";"5,33";"Kuršo";37;"PTT"
8;"Darbo partija";"757";"194";"951";"6,57";"4,69";"Kuršo";37;"DP"
3;"Lietuvos laisvės sąjunga (liberalai)";"81";"14";"95";"0,66";"2,14";"Kuršo";37;"LLS"
12;"Lietuvos žaliųjų partija";"274";"54";"328";"2,27";"1,94";"Kuršo";37;"LZS"
13;"Politinė partija „Lietuvos sąrašas“";"145";"18";"163";"1,13";"1,72";"Kuršo";37;"LS"
10;"Lietuvos liaudies partija";"98";"19";"117";"0,81";"1,01";"Kuršo";37;"LLP"
4;"S. Buškevičiaus ir Tautininkų koalicija „Prieš korupciją ir skurdą“ (Partija „Jaunoji Lietuva“, Tautininkų sąjunga)";"48";"25";"73";"0,50";"0,54";"Kuršo";37;"JL"
9;"„Drąsos kelias“ politinė partija";"22";"8";"30";"0,21";"0,28";"Kuršo";37;"DK"
2;"Tėvynės sąjunga - Lietuvos krikščionys demokratai";"2225";"440";"2665";"17,79";"21,66";"Mažeikių";38;"TSLKD"
6;"Lietuvos valstiečių ir žaliųjų sąjunga";"3344";"287";"3631";"24,24";"21,54";"Mažeikių";38;"LVZS"
1;"Lietuvos socialdemokratų partija";"2266";"248";"2514";"16,79";"14,43";"Mažeikių";38;"LSDP"
7;"Lietuvos Respublikos liberalų sąjūdis";"707";"159";"866";"5,78";"9,04";"Mažeikių";38;"LRLS"
14;"Antikorupcinė N. Puteikio ir K. Krivicko koalicija (Lietuvos centro partija, Lietuvos pensininkų partiją)";"1668";"94";"1762";"11,76";"6,06";"Mažeikių";38;"PUTKA"
11;"Lietuvos lenkų rinkimų akcija-Krikščioniškų šeimų sąjunga";"62";"4";"66";"0,44";"5,49";"Mažeikių";38;"LLRA"
5;"Partija Tvarka ir teisingumas";"1288";"127";"1415";"9,45";"5,33";"Mažeikių";38;"PTT"
8;"Darbo partija";"391";"42";"433";"2,89";"4,69";"Mažeikių";38;"DP"
3;"Lietuvos laisvės sąjunga (liberalai)";"103";"15";"118";"0,79";"2,14";"Mažeikių";38;"LLS"
12;"Lietuvos žaliųjų partija";"241";"19";"260";"1,74";"1,94";"Mažeikių";38;"LZS"
13;"Politinė partija „Lietuvos sąrašas“";"260";"23";"283";"1,89";"1,72";"Mažeikių";38;"LS"
10;"Lietuvos liaudies partija";"156";"5";"161";"1,07";"1,01";"Mažeikių";38;"LLP"
4;"S. Buškevičiaus ir Tautininkų koalicija „Prieš korupciją ir skurdą“ (Partija „Jaunoji Lietuva“, Tautininkų sąjunga)";"84";"8";"92";"0,61";"0,54";"Mažeikių";38;"JL"
9;"„Drąsos kelias“ politinė partija";"28";"1";"29";"0,19";"0,28";"Mažeikių";38;"DK"
2;"Tėvynės sąjunga - Lietuvos krikščionys demokratai";"1467";"433";"1900";"12,00";"21,66";"Akmenės-Mažeikių";39;"TSLKD"
6;"Lietuvos valstiečių ir žaliųjų sąjunga";"3762";"594";"4356";"27,51";"21,54";"Akmenės-Mažeikių";39;"LVZS"
1;"Lietuvos socialdemokratų partija";"2657";"512";"3169";"20,02";"14,43";"Akmenės-Mažeikių";39;"LSDP"
7;"Lietuvos Respublikos liberalų sąjūdis";"1125";"290";"1415";"8,94";"9,04";"Akmenės-Mažeikių";39;"LRLS"
14;"Antikorupcinė N. Puteikio ir K. Krivicko koalicija (Lietuvos centro partija, Lietuvos pensininkų partiją)";"1115";"154";"1269";"8,02";"6,06";"Akmenės-Mažeikių";39;"PUTKA"
11;"Lietuvos lenkų rinkimų akcija-Krikščioniškų šeimų sąjunga";"36";"4";"40";"0,25";"5,49";"Akmenės-Mažeikių";39;"LLRA"
5;"Partija Tvarka ir teisingumas";"995";"233";"1228";"7,76";"5,33";"Akmenės-Mažeikių";39;"PTT"
8;"Darbo partija";"558";"131";"689";"4,35";"4,69";"Akmenės-Mažeikių";39;"DP"
3;"Lietuvos laisvės sąjunga (liberalai)";"134";"37";"171";"1,08";"2,14";"Akmenės-Mažeikių";39;"LLS"
12;"Lietuvos žaliųjų partija";"236";"34";"270";"1,71";"1,94";"Akmenės-Mažeikių";39;"LZS"
13;"Politinė partija „Lietuvos sąrašas“";"133";"14";"147";"0,93";"1,72";"Akmenės-Mažeikių";39;"LS"
10;"Lietuvos liaudies partija";"103";"20";"123";"0,78";"1,01";"Akmenės-Mažeikių";39;"LLP"
4;"S. Buškevičiaus ir Tautininkų koalicija „Prieš korupciją ir skurdą“ (Partija „Jaunoji Lietuva“, Tautininkų sąjunga)";"109";"22";"131";"0,83";"0,54";"Akmenės-Mažeikių";39;"JL"
9;"„Drąsos kelias“ politinė partija";"39";"9";"48";"0,30";"0,28";"Akmenės-Mažeikių";39;"DK"
2;"Tėvynės sąjunga - Lietuvos krikščionys demokratai";"2047";"546";"2593";"14,44";"21,66";"Telšių";40;"TSLKD"
6;"Lietuvos valstiečių ir žaliųjų sąjunga";"3431";"547";"3978";"22,15";"21,54";"Telšių";40;"LVZS"
1;"Lietuvos socialdemokratų partija";"2536";"456";"2992";"16,66";"14,43";"Telšių";40;"LSDP"
7;"Lietuvos Respublikos liberalų sąjūdis";"697";"180";"877";"4,88";"9,04";"Telšių";40;"LRLS"
14;"Antikorupcinė N. Puteikio ir K. Krivicko koalicija (Lietuvos centro partija, Lietuvos pensininkų partiją)";"1199";"161";"1360";"7,57";"6,06";"Telšių";40;"PUTKA"
11;"Lietuvos lenkų rinkimų akcija-Krikščioniškų šeimų sąjunga";"17";"3";"20";"0,11";"5,49";"Telšių";40;"LLRA"
5;"Partija Tvarka ir teisingumas";"1488";"346";"1834";"10,21";"5,33";"Telšių";40;"PTT"
8;"Darbo partija";"1767";"369";"2136";"11,89";"4,69";"Telšių";40;"DP"
3;"Lietuvos laisvės sąjunga (liberalai)";"258";"83";"341";"1,90";"2,14";"Telšių";40;"LLS"
12;"Lietuvos žaliųjų partija";"274";"33";"307";"1,71";"1,94";"Telšių";40;"LZS"
13;"Politinė partija „Lietuvos sąrašas“";"466";"37";"503";"2,80";"1,72";"Telšių";40;"LS"
10;"Lietuvos liaudies partija";"79";"13";"92";"0,51";"1,01";"Telšių";40;"LLP"
4;"S. Buškevičiaus ir Tautininkų koalicija „Prieš korupciją ir skurdą“ (Partija „Jaunoji Lietuva“, Tautininkų sąjunga)";"83";"18";"101";"0,56";"0,54";"Telšių";40;"JL"
9;"„Drąsos kelias“ politinė partija";"19";"8";"27";"0,15";"0,28";"Telšių";40;"DK"
2;"Tėvynės sąjunga - Lietuvos krikščionys demokratai";"1444";"417";"1861";"11,77";"21,66";"Kelmės-Šiaulių";41;"TSLKD"
6;"Lietuvos valstiečių ir žaliųjų sąjunga";"4883";"974";"5857";"37,04";"21,54";"Kelmės-Šiaulių";41;"LVZS"
1;"Lietuvos socialdemokratų partija";"2464";"696";"3160";"19,98";"14,43";"Kelmės-Šiaulių";41;"LSDP"
7;"Lietuvos Respublikos liberalų sąjūdis";"804";"179";"983";"6,22";"9,04";"Kelmės-Šiaulių";41;"LRLS"
14;"Antikorupcinė N. Puteikio ir K. Krivicko koalicija (Lietuvos centro partija, Lietuvos pensininkų partiją)";"609";"104";"713";"4,51";"6,06";"Kelmės-Šiaulių";41;"PUTKA"
11;"Lietuvos lenkų rinkimų akcija-Krikščioniškų šeimų sąjunga";"33";"6";"39";"0,25";"5,49";"Kelmės-Šiaulių";41;"LLRA"
5;"Partija Tvarka ir teisingumas";"606";"201";"807";"5,10";"5,33";"Kelmės-Šiaulių";41;"PTT"
8;"Darbo partija";"415";"143";"558";"3,53";"4,69";"Kelmės-Šiaulių";41;"DP"
3;"Lietuvos laisvės sąjunga (liberalai)";"401";"80";"481";"3,04";"2,14";"Kelmės-Šiaulių";41;"LLS"
12;"Lietuvos žaliųjų partija";"258";"33";"291";"1,84";"1,94";"Kelmės-Šiaulių";41;"LZS"
13;"Politinė partija „Lietuvos sąrašas“";"97";"15";"112";"0,71";"1,72";"Kelmės-Šiaulių";41;"LS"
10;"Lietuvos liaudies partija";"126";"26";"152";"0,96";"1,01";"Kelmės-Šiaulių";41;"LLP"
4;"S. Buškevičiaus ir Tautininkų koalicija „Prieš korupciją ir skurdą“ (Partija „Jaunoji Lietuva“, Tautininkų sąjunga)";"70";"32";"102";"0,64";"0,54";"Kelmės-Šiaulių";41;"JL"
9;"„Drąsos kelias“ politinė partija";"21";"6";"27";"0,17";"0,28";"Kelmės-Šiaulių";41;"DK"
2;"Tėvynės sąjunga - Lietuvos krikščionys demokratai";"2333";"665";"2998";"14,39";"21,66";"Raseinių-Kėdainių";42;"TSLKD"
6;"Lietuvos valstiečių ir žaliųjų sąjunga";"4946";"911";"5857";"28,10";"21,54";"Raseinių-Kėdainių";42;"LVZS"
1;"Lietuvos socialdemokratų partija";"2943";"763";"3706";"17,78";"14,43";"Raseinių-Kėdainių";42;"LSDP"
7;"Lietuvos Respublikos liberalų sąjūdis";"664";"162";"826";"3,96";"9,04";"Raseinių-Kėdainių";42;"LRLS"
14;"Antikorupcinė N. Puteikio ir K. Krivicko koalicija (Lietuvos centro partija, Lietuvos pensininkų partiją)";"830";"157";"987";"4,74";"6,06";"Raseinių-Kėdainių";42;"PUTKA"
11;"Lietuvos lenkų rinkimų akcija-Krikščioniškų šeimų sąjunga";"22";"3";"25";"0,12";"5,49";"Raseinių-Kėdainių";42;"LLRA"
5;"Partija Tvarka ir teisingumas";"1231";"345";"1576";"7,56";"5,33";"Raseinių-Kėdainių";42;"PTT"
8;"Darbo partija";"1857";"534";"2391";"11,47";"4,69";"Raseinių-Kėdainių";42;"DP"
3;"Lietuvos laisvės sąjunga (liberalai)";"78";"29";"107";"0,51";"2,14";"Raseinių-Kėdainių";42;"LLS"
12;"Lietuvos žaliųjų partija";"427";"85";"512";"2,46";"1,94";"Raseinių-Kėdainių";42;"LZS"
13;"Politinė partija „Lietuvos sąrašas“";"133";"28";"161";"0,77";"1,72";"Raseinių-Kėdainių";42;"LS"
10;"Lietuvos liaudies partija";"252";"43";"295";"1,42";"1,01";"Raseinių-Kėdainių";42;"LLP"
4;"S. Buškevičiaus ir Tautininkų koalicija „Prieš korupciją ir skurdą“ (Partija „Jaunoji Lietuva“, Tautininkų sąjunga)";"57";"25";"82";"0,39";"0,54";"Raseinių-Kėdainių";42;"JL"
9;"„Drąsos kelias“ politinė partija";"49";"18";"67";"0,32";"0,28";"Raseinių-Kėdainių";42;"DK"
2;"Tėvynės sąjunga - Lietuvos krikščionys demokratai";"2632";"545";"3177";"16,40";"21,66";"Kėdainių";43;"TSLKD"
6;"Lietuvos valstiečių ir žaliųjų sąjunga";"4079";"673";"4752";"24,53";"21,54";"Kėdainių";43;"LVZS"
1;"Lietuvos socialdemokratų partija";"2001";"376";"2377";"12,27";"14,43";"Kėdainių";43;"LSDP"
7;"Lietuvos Respublikos liberalų sąjūdis";"1208";"200";"1408";"7,27";"9,04";"Kėdainių";43;"LRLS"
14;"Antikorupcinė N. Puteikio ir K. Krivicko koalicija (Lietuvos centro partija, Lietuvos pensininkų partiją)";"1294";"175";"1469";"7,58";"6,06";"Kėdainių";43;"PUTKA"
11;"Lietuvos lenkų rinkimų akcija-Krikščioniškų šeimų sąjunga";"39";"14";"53";"0,27";"5,49";"Kėdainių";43;"LLRA"
5;"Partija Tvarka ir teisingumas";"533";"152";"685";"3,54";"5,33";"Kėdainių";43;"PTT"
8;"Darbo partija";"2657";"696";"3353";"17,31";"4,69";"Kėdainių";43;"DP"
3;"Lietuvos laisvės sąjunga (liberalai)";"139";"38";"177";"0,91";"2,14";"Kėdainių";43;"LLS"
12;"Lietuvos žaliųjų partija";"342";"55";"397";"2,05";"1,94";"Kėdainių";43;"LZS"
13;"Politinė partija „Lietuvos sąrašas“";"222";"26";"248";"1,28";"1,72";"Kėdainių";43;"LS"
10;"Lietuvos liaudies partija";"137";"29";"166";"0,86";"1,01";"Kėdainių";43;"LLP"
4;"S. Buškevičiaus ir Tautininkų koalicija „Prieš korupciją ir skurdą“ (Partija „Jaunoji Lietuva“, Tautininkų sąjunga)";"99";"28";"127";"0,66";"0,54";"Kėdainių";43;"JL"
9;"„Drąsos kelias“ politinė partija";"44";"7";"51";"0,26";"0,28";"Kėdainių";43;"DK"
2;"Tėvynės sąjunga - Lietuvos krikščionys demokratai";"2299";"611";"2910";"17,80";"21,66";"Radviliškio";44;"TSLKD"
6;"Lietuvos valstiečių ir žaliųjų sąjunga";"4019";"778";"4797";"29,34";"21,54";"Radviliškio";44;"LVZS"
1;"Lietuvos socialdemokratų partija";"2514";"486";"3000";"18,35";"14,43";"Radviliškio";44;"LSDP"
7;"Lietuvos Respublikos liberalų sąjūdis";"690";"130";"820";"5,02";"9,04";"Radviliškio";44;"LRLS"
14;"Antikorupcinė N. Puteikio ir K. Krivicko koalicija (Lietuvos centro partija, Lietuvos pensininkų partiją)";"1085";"150";"1235";"7,55";"6,06";"Radviliškio";44;"PUTKA"
11;"Lietuvos lenkų rinkimų akcija-Krikščioniškų šeimų sąjunga";"57";"4";"61";"0,37";"5,49";"Radviliškio";44;"LLRA"
5;"Partija Tvarka ir teisingumas";"762";"192";"954";"5,84";"5,33";"Radviliškio";44;"PTT"
8;"Darbo partija";"692";"173";"865";"5,29";"4,69";"Radviliškio";44;"DP"
3;"Lietuvos laisvės sąjunga (liberalai)";"89";"20";"109";"0,67";"2,14";"Radviliškio";44;"LLS"
12;"Lietuvos žaliųjų partija";"233";"38";"271";"1,66";"1,94";"Radviliškio";44;"LZS"
13;"Politinė partija „Lietuvos sąrašas“";"204";"35";"239";"1,46";"1,72";"Radviliškio";44;"LS"
10;"Lietuvos liaudies partija";"139";"22";"161";"0,98";"1,01";"Radviliškio";44;"LLP"
4;"S. Buškevičiaus ir Tautininkų koalicija „Prieš korupciją ir skurdą“ (Partija „Jaunoji Lietuva“, Tautininkų sąjunga)";"50";"19";"69";"0,42";"0,54";"Radviliškio";44;"JL"
9;"„Drąsos kelias“ politinė partija";"37";"7";"44";"0,27";"0,28";"Radviliškio";44;"DK"
2;"Tėvynės sąjunga - Lietuvos krikščionys demokratai";"2378";"368";"2746";"14,43";"21,66";"Kuršėnų-Dainų";45;"TSLKD"
6;"Lietuvos valstiečių ir žaliųjų sąjunga";"7221";"592";"7813";"41,06";"21,54";"Kuršėnų-Dainų";45;"LVZS"
1;"Lietuvos socialdemokratų partija";"2356";"198";"2554";"13,42";"14,43";"Kuršėnų-Dainų";45;"LSDP"
7;"Lietuvos Respublikos liberalų sąjūdis";"1195";"173";"1368";"7,19";"9,04";"Kuršėnų-Dainų";45;"LRLS"
14;"Antikorupcinė N. Puteikio ir K. Krivicko koalicija (Lietuvos centro partija, Lietuvos pensininkų partiją)";"1347";"95";"1442";"7,58";"6,06";"Kuršėnų-Dainų";45;"PUTKA"
11;"Lietuvos lenkų rinkimų akcija-Krikščioniškų šeimų sąjunga";"56";"3";"59";"0,31";"5,49";"Kuršėnų-Dainų";45;"LLRA"
5;"Partija Tvarka ir teisingumas";"658";"71";"729";"3,83";"5,33";"Kuršėnų-Dainų";45;"PTT"
8;"Darbo partija";"491";"62";"553";"2,91";"4,69";"Kuršėnų-Dainų";45;"DP"
3;"Lietuvos laisvės sąjunga (liberalai)";"158";"13";"171";"0,90";"2,14";"Kuršėnų-Dainų";45;"LLS"
12;"Lietuvos žaliųjų partija";"261";"29";"290";"1,52";"1,94";"Kuršėnų-Dainų";45;"LZS"
13;"Politinė partija „Lietuvos sąrašas“";"233";"18";"251";"1,32";"1,72";"Kuršėnų-Dainų";45;"LS"
10;"Lietuvos liaudies partija";"191";"19";"210";"1,10";"1,01";"Kuršėnų-Dainų";45;"LLP"
4;"S. Buškevičiaus ir Tautininkų koalicija „Prieš korupciją ir skurdą“ (Partija „Jaunoji Lietuva“, Tautininkų sąjunga)";"57";"7";"64";"0,34";"0,54";"Kuršėnų-Dainų";45;"JL"
9;"„Drąsos kelias“ politinė partija";"31";"3";"34";"0,18";"0,28";"Kuršėnų-Dainų";45;"DK"
2;"Tėvynės sąjunga - Lietuvos krikščionys demokratai";"1581";"466";"2047";"11,16";"21,66";"Žiemgalos";46;"TSLKD"
6;"Lietuvos valstiečių ir žaliųjų sąjunga";"5024";"961";"5985";"32,62";"21,54";"Žiemgalos";46;"LVZS"
1;"Lietuvos socialdemokratų partija";"2452";"604";"3056";"16,66";"14,43";"Žiemgalos";46;"LSDP"
7;"Lietuvos Respublikos liberalų sąjūdis";"1927";"506";"2433";"13,26";"9,04";"Žiemgalos";46;"LRLS"
14;"Antikorupcinė N. Puteikio ir K. Krivicko koalicija (Lietuvos centro partija, Lietuvos pensininkų partiją)";"811";"127";"938";"5,11";"6,06";"Žiemgalos";46;"PUTKA"
11;"Lietuvos lenkų rinkimų akcija-Krikščioniškų šeimų sąjunga";"22";"3";"25";"0,14";"5,49";"Žiemgalos";46;"LLRA"
5;"Partija Tvarka ir teisingumas";"797";"299";"1096";"5,97";"5,33";"Žiemgalos";46;"PTT"
8;"Darbo partija";"614";"235";"849";"4,63";"4,69";"Žiemgalos";46;"DP"
3;"Lietuvos laisvės sąjunga (liberalai)";"322";"82";"404";"2,20";"2,14";"Žiemgalos";46;"LLS"
12;"Lietuvos žaliųjų partija";"239";"42";"281";"1,53";"1,94";"Žiemgalos";46;"LZS"
13;"Politinė partija „Lietuvos sąrašas“";"145";"34";"179";"0,98";"1,72";"Žiemgalos";46;"LS"
10;"Lietuvos liaudies partija";"115";"23";"138";"0,75";"1,01";"Žiemgalos";46;"LLP"
4;"S. Buškevičiaus ir Tautininkų koalicija „Prieš korupciją ir skurdą“ (Partija „Jaunoji Lietuva“, Tautininkų sąjunga)";"68";"26";"94";"0,51";"0,54";"Žiemgalos";46;"JL"
9;"„Drąsos kelias“ politinė partija";"27";"12";"39";"0,21";"0,28";"Žiemgalos";46;"DK"
2;"Tėvynės sąjunga - Lietuvos krikščionys demokratai";"2936";"887";"3823";"21,17";"21,66";"Pasvalio-Pakruojo";47;"TSLKD"
6;"Lietuvos valstiečių ir žaliųjų sąjunga";"4497";"884";"5381";"29,80";"21,54";"Pasvalio-Pakruojo";47;"LVZS"
1;"Lietuvos socialdemokratų partija";"2473";"675";"3148";"17,43";"14,43";"Pasvalio-Pakruojo";47;"LSDP"
7;"Lietuvos Respublikos liberalų sąjūdis";"663";"245";"908";"5,03";"9,04";"Pasvalio-Pakruojo";47;"LRLS"
14;"Antikorupcinė N. Puteikio ir K. Krivicko koalicija (Lietuvos centro partija, Lietuvos pensininkų partiją)";"856";"180";"1036";"5,74";"6,06";"Pasvalio-Pakruojo";47;"PUTKA"
11;"Lietuvos lenkų rinkimų akcija-Krikščioniškų šeimų sąjunga";"23";"5";"28";"0,16";"5,49";"Pasvalio-Pakruojo";47;"LLRA"
5;"Partija Tvarka ir teisingumas";"731";"209";"940";"5,21";"5,33";"Pasvalio-Pakruojo";47;"PTT"
8;"Darbo partija";"534";"211";"745";"4,13";"4,69";"Pasvalio-Pakruojo";47;"DP"
3;"Lietuvos laisvės sąjunga (liberalai)";"202";"58";"260";"1,44";"2,14";"Pasvalio-Pakruojo";47;"LLS"
12;"Lietuvos žaliųjų partija";"365";"62";"427";"2,36";"1,94";"Pasvalio-Pakruojo";47;"LZS"
13;"Politinė partija „Lietuvos sąrašas“";"162";"38";"200";"1,11";"1,72";"Pasvalio-Pakruojo";47;"LS"
10;"Lietuvos liaudies partija";"149";"26";"175";"0,97";"1,01";"Pasvalio-Pakruojo";47;"LLP"
4;"S. Buškevičiaus ir Tautininkų koalicija „Prieš korupciją ir skurdą“ (Partija „Jaunoji Lietuva“, Tautininkų sąjunga)";"106";"25";"131";"0,73";"0,54";"Pasvalio-Pakruojo";47;"JL"
9;"„Drąsos kelias“ politinė partija";"13";"12";"25";"0,14";"0,28";"Pasvalio-Pakruojo";47;"DK"
2;"Tėvynės sąjunga - Lietuvos krikščionys demokratai";"2276";"753";"3029";"16,61";"21,66";"Biržų-Kupiškio";48;"TSLKD"
6;"Lietuvos valstiečių ir žaliųjų sąjunga";"3962";"1009";"4971";"27,27";"21,54";"Biržų-Kupiškio";48;"LVZS"
1;"Lietuvos socialdemokratų partija";"2513";"780";"3293";"18,06";"14,43";"Biržų-Kupiškio";48;"LSDP"
7;"Lietuvos Respublikos liberalų sąjūdis";"1181";"385";"1566";"8,59";"9,04";"Biržų-Kupiškio";48;"LRLS"
14;"Antikorupcinė N. Puteikio ir K. Krivicko koalicija (Lietuvos centro partija, Lietuvos pensininkų partiją)";"910";"203";"1113";"6,10";"6,06";"Biržų-Kupiškio";48;"PUTKA"
11;"Lietuvos lenkų rinkimų akcija-Krikščioniškų šeimų sąjunga";"20";"7";"27";"0,15";"5,49";"Biržų-Kupiškio";48;"LLRA"
5;"Partija Tvarka ir teisingumas";"485";"173";"658";"3,61";"5,33";"Biržų-Kupiškio";48;"PTT"
8;"Darbo partija";"1291";"411";"1702";"9,34";"4,69";"Biržų-Kupiškio";48;"DP"
3;"Lietuvos laisvės sąjunga (liberalai)";"172";"68";"240";"1,32";"2,14";"Biržų-Kupiškio";48;"LLS"
12;"Lietuvos žaliųjų partija";"207";"49";"256";"1,40";"1,94";"Biržų-Kupiškio";48;"LZS"
13;"Politinė partija „Lietuvos sąrašas“";"229";"56";"285";"1,56";"1,72";"Biržų-Kupiškio";48;"LS"
10;"Lietuvos liaudies partija";"151";"27";"178";"0,98";"1,01";"Biržų-Kupiškio";48;"LLP"
4;"S. Buškevičiaus ir Tautininkų koalicija „Prieš korupciją ir skurdą“ (Partija „Jaunoji Lietuva“, Tautininkų sąjunga)";"57";"21";"78";"0,43";"0,54";"Biržų-Kupiškio";48;"JL"
9;"„Drąsos kelias“ politinė partija";"17";"11";"28";"0,15";"0,28";"Biržų-Kupiškio";48;"DK"
2;"Tėvynės sąjunga - Lietuvos krikščionys demokratai";"2616";"807";"3423";"20,82";"21,66";"Anykščių-Panevėžio";49;"TSLKD"
6;"Lietuvos valstiečių ir žaliųjų sąjunga";"4187";"787";"4974";"30,25";"21,54";"Anykščių-Panevėžio";49;"LVZS"
1;"Lietuvos socialdemokratų partija";"1909";"501";"2410";"14,66";"14,43";"Anykščių-Panevėžio";49;"LSDP"
7;"Lietuvos Respublikos liberalų sąjūdis";"1152";"279";"1431";"8,70";"9,04";"Anykščių-Panevėžio";49;"LRLS"
14;"Antikorupcinė N. Puteikio ir K. Krivicko koalicija (Lietuvos centro partija, Lietuvos pensininkų partiją)";"786";"122";"908";"5,52";"6,06";"Anykščių-Panevėžio";49;"PUTKA"
11;"Lietuvos lenkų rinkimų akcija-Krikščioniškų šeimų sąjunga";"16";"9";"25";"0,15";"5,49";"Anykščių-Panevėžio";49;"LLRA"
5;"Partija Tvarka ir teisingumas";"433";"121";"554";"3,37";"5,33";"Anykščių-Panevėžio";49;"PTT"
8;"Darbo partija";"707";"304";"1011";"6,15";"4,69";"Anykščių-Panevėžio";49;"DP"
3;"Lietuvos laisvės sąjunga (liberalai)";"186";"68";"254";"1,54";"2,14";"Anykščių-Panevėžio";49;"LLS"
12;"Lietuvos žaliųjų partija";"237";"45";"282";"1,71";"1,94";"Anykščių-Panevėžio";49;"LZS"
13;"Politinė partija „Lietuvos sąrašas“";"162";"31";"193";"1,17";"1,72";"Anykščių-Panevėžio";49;"LS"
10;"Lietuvos liaudies partija";"108";"26";"134";"0,81";"1,01";"Anykščių-Panevėžio";49;"LLP"
4;"S. Buškevičiaus ir Tautininkų koalicija „Prieš korupciją ir skurdą“ (Partija „Jaunoji Lietuva“, Tautininkų sąjunga)";"54";"16";"70";"0,43";"0,54";"Anykščių-Panevėžio";49;"JL"
9;"„Drąsos kelias“ politinė partija";"20";"9";"29";"0,18";"0,28";"Anykščių-Panevėžio";49;"DK"
2;"Tėvynės sąjunga - Lietuvos krikščionys demokratai";"2429";"760";"3189";"18,98";"21,66";"Sėlos";50;"TSLKD"
6;"Lietuvos valstiečių ir žaliųjų sąjunga";"3118";"542";"3660";"21,79";"21,54";"Sėlos";50;"LVZS"
1;"Lietuvos socialdemokratų partija";"2573";"591";"3164";"18,84";"14,43";"Sėlos";50;"LSDP"
7;"Lietuvos Respublikos liberalų sąjūdis";"590";"185";"775";"4,61";"9,04";"Sėlos";50;"LRLS"
14;"Antikorupcinė N. Puteikio ir K. Krivicko koalicija (Lietuvos centro partija, Lietuvos pensininkų partiją)";"859";"165";"1024";"6,10";"6,06";"Sėlos";50;"PUTKA"
11;"Lietuvos lenkų rinkimų akcija-Krikščioniškų šeimų sąjunga";"31";"7";"38";"0,23";"5,49";"Sėlos";50;"LLRA"
5;"Partija Tvarka ir teisingumas";"1016";"248";"1264";"7,52";"5,33";"Sėlos";50;"PTT"
8;"Darbo partija";"1350";"300";"1650";"9,82";"4,69";"Sėlos";50;"DP"
3;"Lietuvos laisvės sąjunga (liberalai)";"355";"163";"518";"3,08";"2,14";"Sėlos";50;"LLS"
12;"Lietuvos žaliųjų partija";"265";"49";"314";"1,87";"1,94";"Sėlos";50;"LZS"
13;"Politinė partija „Lietuvos sąrašas“";"153";"28";"181";"1,08";"1,72";"Sėlos";50;"LS"
10;"Lietuvos liaudies partija";"130";"21";"151";"0,90";"1,01";"Sėlos";50;"LLP"
4;"S. Buškevičiaus ir Tautininkų koalicija „Prieš korupciją ir skurdą“ (Partija „Jaunoji Lietuva“, Tautininkų sąjunga)";"73";"18";"91";"0,54";"0,54";"Sėlos";50;"JL"
9;"„Drąsos kelias“ politinė partija";"31";"7";"38";"0,23";"0,28";"Sėlos";50;"DK"
2;"Tėvynės sąjunga - Lietuvos krikščionys demokratai";"3611";"766";"4377";"22,78";"21,66";"Utenos";51;"TSLKD"
6;"Lietuvos valstiečių ir žaliųjų sąjunga";"3945";"614";"4559";"23,73";"21,54";"Utenos";51;"LVZS"
1;"Lietuvos socialdemokratų partija";"3221";"706";"3927";"20,44";"14,43";"Utenos";51;"LSDP"
7;"Lietuvos Respublikos liberalų sąjūdis";"1412";"231";"1643";"8,55";"9,04";"Utenos";51;"LRLS"
14;"Antikorupcinė N. Puteikio ir K. Krivicko koalicija (Lietuvos centro partija, Lietuvos pensininkų partiją)";"1129";"121";"1250";"6,51";"6,06";"Utenos";51;"PUTKA"
11;"Lietuvos lenkų rinkimų akcija-Krikščioniškų šeimų sąjunga";"34";"4";"38";"0,20";"5,49";"Utenos";51;"LLRA"
5;"Partija Tvarka ir teisingumas";"589";"115";"704";"3,66";"5,33";"Utenos";51;"PTT"
8;"Darbo partija";"350";"102";"452";"2,35";"4,69";"Utenos";51;"DP"
3;"Lietuvos laisvės sąjunga (liberalai)";"201";"47";"248";"1,29";"2,14";"Utenos";51;"LLS"
12;"Lietuvos žaliųjų partija";"560";"76";"636";"3,31";"1,94";"Utenos";51;"LZS"
13;"Politinė partija „Lietuvos sąrašas“";"286";"26";"312";"1,62";"1,72";"Utenos";51;"LS"
10;"Lietuvos liaudies partija";"141";"18";"159";"0,83";"1,01";"Utenos";51;"LLP"
4;"S. Buškevičiaus ir Tautininkų koalicija „Prieš korupciją ir skurdą“ (Partija „Jaunoji Lietuva“, Tautininkų sąjunga)";"63";"12";"75";"0,39";"0,54";"Utenos";51;"JL"
9;"„Drąsos kelias“ politinė partija";"46";"5";"51";"0,27";"0,28";"Utenos";51;"DK"
2;"Tėvynės sąjunga - Lietuvos krikščionys demokratai";"940";"354";"1294";"9,68";"21,66";"Visagino-Zarasų";52;"TSLKD"
6;"Lietuvos valstiečių ir žaliųjų sąjunga";"1602";"402";"2004";"15,00";"21,54";"Visagino-Zarasų";52;"LVZS"
1;"Lietuvos socialdemokratų partija";"1286";"398";"1684";"12,60";"14,43";"Visagino-Zarasų";52;"LSDP"
7;"Lietuvos Respublikos liberalų sąjūdis";"485";"196";"681";"5,10";"9,04";"Visagino-Zarasų";52;"LRLS"
14;"Antikorupcinė N. Puteikio ir K. Krivicko koalicija (Lietuvos centro partija, Lietuvos pensininkų partiją)";"359";"101";"460";"3,44";"6,06";"Visagino-Zarasų";52;"PUTKA"
11;"Lietuvos lenkų rinkimų akcija-Krikščioniškų šeimų sąjunga";"970";"154";"1124";"8,41";"5,49";"Visagino-Zarasų";52;"LLRA"
5;"Partija Tvarka ir teisingumas";"2858";"423";"3281";"24,55";"5,33";"Visagino-Zarasų";52;"PTT"
8;"Darbo partija";"871";"333";"1204";"9,01";"4,69";"Visagino-Zarasų";52;"DP"
3;"Lietuvos laisvės sąjunga (liberalai)";"424";"98";"522";"3,91";"2,14";"Visagino-Zarasų";52;"LLS"
12;"Lietuvos žaliųjų partija";"125";"25";"150";"1,12";"1,94";"Visagino-Zarasų";52;"LZS"
13;"Politinė partija „Lietuvos sąrašas“";"119";"37";"156";"1,17";"1,72";"Visagino-Zarasų";52;"LS"
10;"Lietuvos liaudies partija";"61";"15";"76";"0,57";"1,01";"Visagino-Zarasų";52;"LLP"
4;"S. Buškevičiaus ir Tautininkų koalicija „Prieš korupciją ir skurdą“ (Partija „Jaunoji Lietuva“, Tautininkų sąjunga)";"41";"15";"56";"0,42";"0,54";"Visagino-Zarasų";52;"JL"
9;"„Drąsos kelias“ politinė partija";"89";"11";"100";"0,75";"0,28";"Visagino-Zarasų";52;"DK"
2;"Tėvynės sąjunga - Lietuvos krikščionys demokratai";"1653";"521";"2174";"11,48";"21,66";"Nalšios";53;"TSLKD"
6;"Lietuvos valstiečių ir žaliųjų sąjunga";"4017";"1356";"5373";"28,37";"21,54";"Nalšios";53;"LVZS"
1;"Lietuvos socialdemokratų partija";"1740";"565";"2305";"12,17";"14,43";"Nalšios";53;"LSDP"
7;"Lietuvos Respublikos liberalų sąjūdis";"638";"187";"825";"4,36";"9,04";"Nalšios";53;"LRLS"
14;"Antikorupcinė N. Puteikio ir K. Krivicko koalicija (Lietuvos centro partija, Lietuvos pensininkų partiją)";"480";"152";"632";"3,34";"6,06";"Nalšios";53;"PUTKA"
11;"Lietuvos lenkų rinkimų akcija-Krikščioniškų šeimų sąjunga";"1489";"481";"1970";"10,40";"5,49";"Nalšios";53;"LLRA"
5;"Partija Tvarka ir teisingumas";"719";"267";"986";"5,21";"5,33";"Nalšios";53;"PTT"
8;"Darbo partija";"1294";"439";"1733";"9,15";"4,69";"Nalšios";53;"DP"
3;"Lietuvos laisvės sąjunga (liberalai)";"948";"355";"1303";"6,88";"2,14";"Nalšios";53;"LLS"
12;"Lietuvos žaliųjų partija";"265";"60";"325";"1,72";"1,94";"Nalšios";53;"LZS"
13;"Politinė partija „Lietuvos sąrašas“";"88";"27";"115";"0,61";"1,72";"Nalšios";53;"LS"
10;"Lietuvos liaudies partija";"130";"53";"183";"0,97";"1,01";"Nalšios";53;"LLP"
4;"S. Buškevičiaus ir Tautininkų koalicija „Prieš korupciją ir skurdą“ (Partija „Jaunoji Lietuva“, Tautininkų sąjunga)";"74";"35";"109";"0,58";"0,54";"Nalšios";53;"JL"
9;"„Drąsos kelias“ politinė partija";"19";"7";"26";"0,14";"0,28";"Nalšios";53;"DK"
2;"Tėvynės sąjunga - Lietuvos krikščionys demokratai";"2431";"757";"3188";"19,29";"21,66";"Molėtų-Širvintų";54;"TSLKD"
6;"Lietuvos valstiečių ir žaliųjų sąjunga";"2470";"511";"2981";"18,04";"21,54";"Molėtų-Širvintų";54;"LVZS"
1;"Lietuvos socialdemokratų partija";"1879";"490";"2369";"14,33";"14,43";"Molėtų-Širvintų";54;"LSDP"
7;"Lietuvos Respublikos liberalų sąjūdis";"797";"160";"957";"5,79";"9,04";"Molėtų-Širvintų";54;"LRLS"
14;"Antikorupcinė N. Puteikio ir K. Krivicko koalicija (Lietuvos centro partija, Lietuvos pensininkų partiją)";"689";"126";"815";"4,93";"6,06";"Molėtų-Širvintų";54;"PUTKA"
11;"Lietuvos lenkų rinkimų akcija-Krikščioniškų šeimų sąjunga";"324";"96";"420";"2,54";"5,49";"Molėtų-Širvintų";54;"LLRA"
5;"Partija Tvarka ir teisingumas";"359";"116";"475";"2,87";"5,33";"Molėtų-Širvintų";54;"PTT"
8;"Darbo partija";"2608";"864";"3472";"21,01";"4,69";"Molėtų-Širvintų";54;"DP"
3;"Lietuvos laisvės sąjunga (liberalai)";"331";"70";"401";"2,43";"2,14";"Molėtų-Širvintų";54;"LLS"
12;"Lietuvos žaliųjų partija";"272";"62";"334";"2,02";"1,94";"Molėtų-Širvintų";54;"LZS"
13;"Politinė partija „Lietuvos sąrašas“";"148";"26";"174";"1,05";"1,72";"Molėtų-Širvintų";54;"LS"
10;"Lietuvos liaudies partija";"93";"18";"111";"0,67";"1,01";"Molėtų-Širvintų";54;"LLP"
4;"S. Buškevičiaus ir Tautininkų koalicija „Prieš korupciją ir skurdą“ (Partija „Jaunoji Lietuva“, Tautininkų sąjunga)";"87";"21";"108";"0,65";"0,54";"Molėtų-Širvintų";54;"JL"
9;"„Drąsos kelias“ politinė partija";"22";"13";"35";"0,21";"0,28";"Molėtų-Širvintų";54;"DK"
2;"Tėvynės sąjunga - Lietuvos krikščionys demokratai";"3395";"270";"3665";"17,71";"21,66";"Nemenčinės";55;"TSLKD"
6;"Lietuvos valstiečių ir žaliųjų sąjunga";"1568";"107";"1675";"8,09";"21,54";"Nemenčinės";55;"LVZS"
1;"Lietuvos socialdemokratų partija";"1259";"122";"1381";"6,67";"14,43";"Nemenčinės";55;"LSDP"
7;"Lietuvos Respublikos liberalų sąjūdis";"1594";"118";"1712";"8,27";"9,04";"Nemenčinės";55;"LRLS"
14;"Antikorupcinė N. Puteikio ir K. Krivicko koalicija (Lietuvos centro partija, Lietuvos pensininkų partiją)";"296";"29";"325";"1,57";"6,06";"Nemenčinės";55;"PUTKA"
11;"Lietuvos lenkų rinkimų akcija-Krikščioniškų šeimų sąjunga";"6987";"1905";"8892";"42,97";"5,49";"Nemenčinės";55;"LLRA"
5;"Partija Tvarka ir teisingumas";"534";"76";"610";"2,95";"5,33";"Nemenčinės";55;"PTT"
8;"Darbo partija";"560";"79";"639";"3,09";"4,69";"Nemenčinės";55;"DP"
3;"Lietuvos laisvės sąjunga (liberalai)";"487";"35";"522";"2,52";"2,14";"Nemenčinės";55;"LLS"
12;"Lietuvos žaliųjų partija";"240";"20";"260";"1,26";"1,94";"Nemenčinės";55;"LZS"
13;"Politinė partija „Lietuvos sąrašas“";"189";"11";"200";"0,97";"1,72";"Nemenčinės";55;"LS"
10;"Lietuvos liaudies partija";"112";"18";"130";"0,63";"1,01";"Nemenčinės";55;"LLP"
4;"S. Buškevičiaus ir Tautininkų koalicija „Prieš korupciją ir skurdą“ (Partija „Jaunoji Lietuva“, Tautininkų sąjunga)";"46";"10";"56";"0,27";"0,54";"Nemenčinės";55;"JL"
9;"„Drąsos kelias“ politinė partija";"19";"9";"28";"0,14";"0,28";"Nemenčinės";55;"DK"
2;"Tėvynės sąjunga - Lietuvos krikščionys demokratai";"686";"113";"799";"4,42";"21,66";"Šalčininkų-Vilniaus";56;"TSLKD"
6;"Lietuvos valstiečių ir žaliųjų sąjunga";"599";"63";"662";"3,66";"21,54";"Šalčininkų-Vilniaus";56;"LVZS"
1;"Lietuvos socialdemokratų partija";"621";"81";"702";"3,88";"14,43";"Šalčininkų-Vilniaus";56;"LSDP"
7;"Lietuvos Respublikos liberalų sąjūdis";"465";"58";"523";"2,89";"9,04";"Šalčininkų-Vilniaus";56;"LRLS"
14;"Antikorupcinė N. Puteikio ir K. Krivicko koalicija (Lietuvos centro partija, Lietuvos pensininkų partiją)";"199";"41";"240";"1,33";"6,06";"Šalčininkų-Vilniaus";56;"PUTKA"
11;"Lietuvos lenkų rinkimų akcija-Krikščioniškų šeimų sąjunga";"9392";"2641";"12033";"66,53";"5,49";"Šalčininkų-Vilniaus";56;"LLRA"
5;"Partija Tvarka ir teisingumas";"690";"100";"790";"4,37";"5,33";"Šalčininkų-Vilniaus";56;"PTT"
8;"Darbo partija";"814";"130";"944";"5,22";"4,69";"Šalčininkų-Vilniaus";56;"DP"
3;"Lietuvos laisvės sąjunga (liberalai)";"159";"28";"187";"1,03";"2,14";"Šalčininkų-Vilniaus";56;"LLS"
12;"Lietuvos žaliųjų partija";"101";"19";"120";"0,66";"1,94";"Šalčininkų-Vilniaus";56;"LZS"
13;"Politinė partija „Lietuvos sąrašas“";"58";"14";"72";"0,40";"1,72";"Šalčininkų-Vilniaus";56;"LS"
10;"Lietuvos liaudies partija";"98";"10";"108";"0,60";"1,01";"Šalčininkų-Vilniaus";56;"LLP"
4;"S. Buškevičiaus ir Tautininkų koalicija „Prieš korupciją ir skurdą“ (Partija „Jaunoji Lietuva“, Tautininkų sąjunga)";"29";"20";"49";"0,27";"0,54";"Šalčininkų-Vilniaus";56;"JL"
9;"„Drąsos kelias“ politinė partija";"20";"8";"28";"0,15";"0,28";"Šalčininkų-Vilniaus";56;"DK"
2;"Tėvynės sąjunga - Lietuvos krikščionys demokratai";"1280";"110";"1390";"7,36";"21,66";"Medininkų";57;"TSLKD"
6;"Lietuvos valstiečių ir žaliųjų sąjunga";"917";"60";"977";"5,17";"21,54";"Medininkų";57;"LVZS"
1;"Lietuvos socialdemokratų partija";"908";"86";"994";"5,26";"14,43";"Medininkų";57;"LSDP"
7;"Lietuvos Respublikos liberalų sąjūdis";"712";"68";"780";"4,13";"9,04";"Medininkų";57;"LRLS"
14;"Antikorupcinė N. Puteikio ir K. Krivicko koalicija (Lietuvos centro partija, Lietuvos pensininkų partiją)";"208";"28";"236";"1,25";"6,06";"Medininkų";57;"PUTKA"
11;"Lietuvos lenkų rinkimų akcija-Krikščioniškų šeimų sąjunga";"8806";"2396";"11202";"59,28";"5,49";"Medininkų";57;"LLRA"
5;"Partija Tvarka ir teisingumas";"850";"89";"939";"4,97";"5,33";"Medininkų";57;"PTT"
8;"Darbo partija";"851";"83";"934";"4,94";"4,69";"Medininkų";57;"DP"
3;"Lietuvos laisvės sąjunga (liberalai)";"297";"14";"311";"1,65";"2,14";"Medininkų";57;"LLS"
12;"Lietuvos žaliųjų partija";"143";"17";"160";"0,85";"1,94";"Medininkų";57;"LZS"
13;"Politinė partija „Lietuvos sąrašas“";"129";"8";"137";"0,72";"1,72";"Medininkų";57;"LS"
10;"Lietuvos liaudies partija";"107";"14";"121";"0,64";"1,01";"Medininkų";57;"LLP"
4;"S. Buškevičiaus ir Tautininkų koalicija „Prieš korupciją ir skurdą“ (Partija „Jaunoji Lietuva“, Tautininkų sąjunga)";"38";"4";"42";"0,22";"0,54";"Medininkų";57;"JL"
9;"„Drąsos kelias“ politinė partija";"22";"1";"23";"0,12";"0,28";"Medininkų";57;"DK"
2;"Tėvynės sąjunga - Lietuvos krikščionys demokratai";"2137";"259";"2396";"15,82";"21,66";"Trakų-Vievio";58;"TSLKD"
6;"Lietuvos valstiečių ir žaliųjų sąjunga";"2027";"208";"2235";"14,76";"21,54";"Trakų-Vievio";58;"LVZS"
1;"Lietuvos socialdemokratų partija";"1545";"232";"1777";"11,73";"14,43";"Trakų-Vievio";58;"LSDP"
7;"Lietuvos Respublikos liberalų sąjūdis";"1645";"196";"1841";"12,16";"9,04";"Trakų-Vievio";58;"LRLS"
14;"Antikorupcinė N. Puteikio ir K. Krivicko koalicija (Lietuvos centro partija, Lietuvos pensininkų partiją)";"637";"86";"723";"4,77";"6,06";"Trakų-Vievio";58;"PUTKA"
11;"Lietuvos lenkų rinkimų akcija-Krikščioniškų šeimų sąjunga";"1880";"239";"2119";"13,99";"5,49";"Trakų-Vievio";58;"LLRA"
5;"Partija Tvarka ir teisingumas";"710";"126";"836";"5,52";"5,33";"Trakų-Vievio";58;"PTT"
8;"Darbo partija";"947";"157";"1104";"7,29";"4,69";"Trakų-Vievio";58;"DP"
3;"Lietuvos laisvės sąjunga (liberalai)";"578";"51";"629";"4,15";"2,14";"Trakų-Vievio";58;"LLS"
12;"Lietuvos žaliųjų partija";"249";"23";"272";"1,80";"1,94";"Trakų-Vievio";58;"LZS"
13;"Politinė partija „Lietuvos sąrašas“";"277";"39";"316";"2,09";"1,72";"Trakų-Vievio";58;"LS"
10;"Lietuvos liaudies partija";"123";"10";"133";"0,88";"1,01";"Trakų-Vievio";58;"LLP"
4;"S. Buškevičiaus ir Tautininkų koalicija „Prieš korupciją ir skurdą“ (Partija „Jaunoji Lietuva“, Tautininkų sąjunga)";"59";"16";"75";"0,50";"0,54";"Trakų-Vievio";58;"JL"
9;"„Drąsos kelias“ politinė partija";"19";"7";"26";"0,17";"0,28";"Trakų-Vievio";58;"DK"
2;"Tėvynės sąjunga - Lietuvos krikščionys demokratai";"2861";"667";"3528";"19,25";"21,66";"Kaišiadorių-Elektrėnų";59;"TSLKD"
6;"Lietuvos valstiečių ir žaliųjų sąjunga";"3698";"650";"4348";"23,73";"21,54";"Kaišiadorių-Elektrėnų";59;"LVZS"
1;"Lietuvos socialdemokratų partija";"2922";"663";"3585";"19,56";"14,43";"Kaišiadorių-Elektrėnų";59;"LSDP"
7;"Lietuvos Respublikos liberalų sąjūdis";"1282";"308";"1590";"8,68";"9,04";"Kaišiadorių-Elektrėnų";59;"LRLS"
14;"Antikorupcinė N. Puteikio ir K. Krivicko koalicija (Lietuvos centro partija, Lietuvos pensininkų partiją)";"979";"248";"1227";"6,70";"6,06";"Kaišiadorių-Elektrėnų";59;"PUTKA"
11;"Lietuvos lenkų rinkimų akcija-Krikščioniškų šeimų sąjunga";"147";"26";"173";"0,94";"5,49";"Kaišiadorių-Elektrėnų";59;"LLRA"
5;"Partija Tvarka ir teisingumas";"634";"177";"811";"4,43";"5,33";"Kaišiadorių-Elektrėnų";59;"PTT"
8;"Darbo partija";"512";"202";"714";"3,90";"4,69";"Kaišiadorių-Elektrėnų";59;"DP"
3;"Lietuvos laisvės sąjunga (liberalai)";"259";"74";"333";"1,82";"2,14";"Kaišiadorių-Elektrėnų";59;"LLS"
12;"Lietuvos žaliųjų partija";"300";"57";"357";"1,95";"1,94";"Kaišiadorių-Elektrėnų";59;"LZS"
13;"Politinė partija „Lietuvos sąrašas“";"502";"77";"579";"3,16";"1,72";"Kaišiadorių-Elektrėnų";59;"LS"
10;"Lietuvos liaudies partija";"138";"24";"162";"0,88";"1,01";"Kaišiadorių-Elektrėnų";59;"LLP"
4;"S. Buškevičiaus ir Tautininkų koalicija „Prieš korupciją ir skurdą“ (Partija „Jaunoji Lietuva“, Tautininkų sąjunga)";"73";"23";"96";"0,52";"0,54";"Kaišiadorių-Elektrėnų";59;"JL"
9;"„Drąsos kelias“ politinė partija";"34";"11";"45";"0,25";"0,28";"Kaišiadorių-Elektrėnų";59;"DK"
2;"Tėvynės sąjunga - Lietuvos krikščionys demokratai";"2411";"387";"2798";"16,54";"21,66";"Jonavos";60;"TSLKD"
6;"Lietuvos valstiečių ir žaliųjų sąjunga";"3256";"381";"3637";"21,50";"21,54";"Jonavos";60;"LVZS"
1;"Lietuvos socialdemokratų partija";"3794";"570";"4364";"25,79";"14,43";"Jonavos";60;"LSDP"
7;"Lietuvos Respublikos liberalų sąjūdis";"1306";"247";"1553";"9,18";"9,04";"Jonavos";60;"LRLS"
14;"Antikorupcinė N. Puteikio ir K. Krivicko koalicija (Lietuvos centro partija, Lietuvos pensininkų partiją)";"929";"87";"1016";"6,01";"6,06";"Jonavos";60;"PUTKA"
11;"Lietuvos lenkų rinkimų akcija-Krikščioniškų šeimų sąjunga";"110";"7";"117";"0,69";"5,49";"Jonavos";60;"LLRA"
5;"Partija Tvarka ir teisingumas";"554";"115";"669";"3,95";"5,33";"Jonavos";60;"PTT"
8;"Darbo partija";"728";"158";"886";"5,24";"4,69";"Jonavos";60;"DP"
3;"Lietuvos laisvės sąjunga (liberalai)";"172";"26";"198";"1,17";"2,14";"Jonavos";60;"LLS"
12;"Lietuvos žaliųjų partija";"284";"43";"327";"1,93";"1,94";"Jonavos";60;"LZS"
13;"Politinė partija „Lietuvos sąrašas“";"253";"32";"285";"1,68";"1,72";"Jonavos";60;"LS"
10;"Lietuvos liaudies partija";"192";"23";"215";"1,27";"1,01";"Jonavos";60;"LLP"
4;"S. Buškevičiaus ir Tautininkų koalicija „Prieš korupciją ir skurdą“ (Partija „Jaunoji Lietuva“, Tautininkų sąjunga)";"67";"19";"86";"0,51";"0,54";"Jonavos";60;"JL"
9;"„Drąsos kelias“ politinė partija";"29";"10";"39";"0,23";"0,28";"Jonavos";60;"DK"
2;"Tėvynės sąjunga - Lietuvos krikščionys demokratai";"2518";"557";"3075";"18,52";"21,66";"Ukmergės";61;"TSLKD"
6;"Lietuvos valstiečių ir žaliųjų sąjunga";"3425";"694";"4119";"24,81";"21,54";"Ukmergės";61;"LVZS"
1;"Lietuvos socialdemokratų partija";"2177";"513";"2690";"16,20";"14,43";"Ukmergės";61;"LSDP"
7;"Lietuvos Respublikos liberalų sąjūdis";"676";"144";"820";"4,94";"9,04";"Ukmergės";61;"LRLS"
14;"Antikorupcinė N. Puteikio ir K. Krivicko koalicija (Lietuvos centro partija, Lietuvos pensininkų partiją)";"1077";"168";"1245";"7,50";"6,06";"Ukmergės";61;"PUTKA"
11;"Lietuvos lenkų rinkimų akcija-Krikščioniškų šeimų sąjunga";"61";"8";"69";"0,42";"5,49";"Ukmergės";61;"LLRA"
5;"Partija Tvarka ir teisingumas";"678";"222";"900";"5,42";"5,33";"Ukmergės";61;"PTT"
8;"Darbo partija";"1280";"296";"1576";"9,49";"4,69";"Ukmergės";61;"DP"
3;"Lietuvos laisvės sąjunga (liberalai)";"226";"61";"287";"1,73";"2,14";"Ukmergės";61;"LLS"
12;"Lietuvos žaliųjų partija";"285";"68";"353";"2,13";"1,94";"Ukmergės";61;"LZS"
13;"Politinė partija „Lietuvos sąrašas“";"288";"46";"334";"2,01";"1,72";"Ukmergės";61;"LS"
10;"Lietuvos liaudies partija";"135";"48";"183";"1,10";"1,01";"Ukmergės";61;"LLP"
4;"S. Buškevičiaus ir Tautininkų koalicija „Prieš korupciją ir skurdą“ (Partija „Jaunoji Lietuva“, Tautininkų sąjunga)";"66";"18";"84";"0,51";"0,54";"Ukmergės";61;"JL"
9;"„Drąsos kelias“ politinė partija";"32";"9";"41";"0,25";"0,28";"Ukmergės";61;"DK"
2;"Tėvynės sąjunga - Lietuvos krikščionys demokratai";"2311";"640";"2951";"18,19";"21,66";"Jurbarko-Pagėgių";62;"TSLKD"
6;"Lietuvos valstiečių ir žaliųjų sąjunga";"3087";"592";"3679";"22,68";"21,54";"Jurbarko-Pagėgių";62;"LVZS"
1;"Lietuvos socialdemokratų partija";"2084";"546";"2630";"16,21";"14,43";"Jurbarko-Pagėgių";62;"LSDP"
7;"Lietuvos Respublikos liberalų sąjūdis";"1070";"289";"1359";"8,38";"9,04";"Jurbarko-Pagėgių";62;"LRLS"
14;"Antikorupcinė N. Puteikio ir K. Krivicko koalicija (Lietuvos centro partija, Lietuvos pensininkų partiją)";"915";"207";"1122";"6,92";"6,06";"Jurbarko-Pagėgių";62;"PUTKA"
11;"Lietuvos lenkų rinkimų akcija-Krikščioniškų šeimų sąjunga";"16";"6";"22";"0,14";"5,49";"Jurbarko-Pagėgių";62;"LLRA"
5;"Partija Tvarka ir teisingumas";"1521";"468";"1989";"12,26";"5,33";"Jurbarko-Pagėgių";62;"PTT"
8;"Darbo partija";"665";"180";"845";"5,21";"4,69";"Jurbarko-Pagėgių";62;"DP"
3;"Lietuvos laisvės sąjunga (liberalai)";"215";"49";"264";"1,63";"2,14";"Jurbarko-Pagėgių";62;"LLS"
12;"Lietuvos žaliųjų partija";"180";"33";"213";"1,31";"1,94";"Jurbarko-Pagėgių";62;"LZS"
13;"Politinė partija „Lietuvos sąrašas“";"100";"20";"120";"0,74";"1,72";"Jurbarko-Pagėgių";62;"LS"
10;"Lietuvos liaudies partija";"119";"21";"140";"0,86";"1,01";"Jurbarko-Pagėgių";62;"LLP"
4;"S. Buškevičiaus ir Tautininkų koalicija „Prieš korupciją ir skurdą“ (Partija „Jaunoji Lietuva“, Tautininkų sąjunga)";"45";"14";"59";"0,36";"0,54";"Jurbarko-Pagėgių";62;"JL"
9;"„Drąsos kelias“ politinė partija";"10";"10";"20";"0,12";"0,28";"Jurbarko-Pagėgių";62;"DK"
2;"Tėvynės sąjunga - Lietuvos krikščionys demokratai";"1965";"536";"2501";"15,82";"21,66";"Sūduvos";63;"TSLKD"
6;"Lietuvos valstiečių ir žaliųjų sąjunga";"4134";"633";"4767";"30,15";"21,54";"Sūduvos";63;"LVZS"
1;"Lietuvos socialdemokratų partija";"2188";"464";"2652";"16,78";"14,43";"Sūduvos";63;"LSDP"
7;"Lietuvos Respublikos liberalų sąjūdis";"755";"168";"923";"5,84";"9,04";"Sūduvos";63;"LRLS"
14;"Antikorupcinė N. Puteikio ir K. Krivicko koalicija (Lietuvos centro partija, Lietuvos pensininkų partiją)";"830";"151";"981";"6,21";"6,06";"Sūduvos";63;"PUTKA"
11;"Lietuvos lenkų rinkimų akcija-Krikščioniškų šeimų sąjunga";"8";"4";"12";"0,08";"5,49";"Sūduvos";63;"LLRA"
5;"Partija Tvarka ir teisingumas";"1141";"252";"1393";"8,81";"5,33";"Sūduvos";63;"PTT"
8;"Darbo partija";"779";"229";"1008";"6,38";"4,69";"Sūduvos";63;"DP"
3;"Lietuvos laisvės sąjunga (liberalai)";"80";"16";"96";"0,61";"2,14";"Sūduvos";63;"LLS"
12;"Lietuvos žaliųjų partija";"286";"38";"324";"2,05";"1,94";"Sūduvos";63;"LZS"
13;"Politinė partija „Lietuvos sąrašas“";"139";"27";"166";"1,05";"1,72";"Sūduvos";63;"LS"
10;"Lietuvos liaudies partija";"119";"23";"142";"0,90";"1,01";"Sūduvos";63;"LLP"
4;"S. Buškevičiaus ir Tautininkų koalicija „Prieš korupciją ir skurdą“ (Partija „Jaunoji Lietuva“, Tautininkų sąjunga)";"48";"24";"72";"0,46";"0,54";"Sūduvos";63;"JL"
9;"„Drąsos kelias“ politinė partija";"27";"5";"32";"0,20";"0,28";"Sūduvos";63;"DK"
2;"Tėvynės sąjunga - Lietuvos krikščionys demokratai";"2552";"726";"3278";"20,90";"21,66";"Zanavykų";64;"TSLKD"
6;"Lietuvos valstiečių ir žaliųjų sąjunga";"3361";"641";"4002";"25,52";"21,54";"Zanavykų";64;"LVZS"
1;"Lietuvos socialdemokratų partija";"2286";"621";"2907";"18,54";"14,43";"Zanavykų";64;"LSDP"
7;"Lietuvos Respublikos liberalų sąjūdis";"529";"136";"665";"4,24";"9,04";"Zanavykų";64;"LRLS"
14;"Antikorupcinė N. Puteikio ir K. Krivicko koalicija (Lietuvos centro partija, Lietuvos pensininkų partiją)";"1202";"266";"1468";"9,36";"6,06";"Zanavykų";64;"PUTKA"
11;"Lietuvos lenkų rinkimų akcija-Krikščioniškų šeimų sąjunga";"13";"4";"17";"0,11";"5,49";"Zanavykų";64;"LLRA"
5;"Partija Tvarka ir teisingumas";"458";"148";"606";"3,86";"5,33";"Zanavykų";64;"PTT"
8;"Darbo partija";"415";"165";"580";"3,70";"4,69";"Zanavykų";64;"DP"
3;"Lietuvos laisvės sąjunga (liberalai)";"408";"114";"522";"3,33";"2,14";"Zanavykų";64;"LLS"
12;"Lietuvos žaliųjų partija";"294";"61";"355";"2,26";"1,94";"Zanavykų";64;"LZS"
13;"Politinė partija „Lietuvos sąrašas“";"130";"17";"147";"0,94";"1,72";"Zanavykų";64;"LS"
10;"Lietuvos liaudies partija";"86";"32";"118";"0,75";"1,01";"Zanavykų";64;"LLP"
4;"S. Buškevičiaus ir Tautininkų koalicija „Prieš korupciją ir skurdą“ (Partija „Jaunoji Lietuva“, Tautininkų sąjunga)";"57";"34";"91";"0,58";"0,54";"Zanavykų";64;"JL"
9;"„Drąsos kelias“ politinė partija";"28";"5";"33";"0,21";"0,28";"Zanavykų";64;"DK"
2;"Tėvynės sąjunga - Lietuvos krikščionys demokratai";"4363";"423";"4786";"22,94";"21,66";"Raudondvario";65;"TSLKD"
6;"Lietuvos valstiečių ir žaliųjų sąjunga";"4824";"347";"5171";"24,78";"21,54";"Raudondvario";65;"LVZS"
1;"Lietuvos socialdemokratų partija";"3599";"510";"4109";"19,69";"14,43";"Raudondvario";65;"LSDP"
7;"Lietuvos Respublikos liberalų sąjūdis";"1491";"115";"1606";"7,70";"9,04";"Raudondvario";65;"LRLS"
14;"Antikorupcinė N. Puteikio ir K. Krivicko koalicija (Lietuvos centro partija, Lietuvos pensininkų partiją)";"1122";"90";"1212";"5,81";"6,06";"Raudondvario";65;"PUTKA"
11;"Lietuvos lenkų rinkimų akcija-Krikščioniškų šeimų sąjunga";"73";"10";"83";"0,40";"5,49";"Raudondvario";65;"LLRA"
5;"Partija Tvarka ir teisingumas";"678";"105";"783";"3,75";"5,33";"Raudondvario";65;"PTT"
8;"Darbo partija";"679";"86";"765";"3,67";"4,69";"Raudondvario";65;"DP"
3;"Lietuvos laisvės sąjunga (liberalai)";"183";"13";"196";"0,94";"2,14";"Raudondvario";65;"LLS"
12;"Lietuvos žaliųjų partija";"529";"24";"553";"2,65";"1,94";"Raudondvario";65;"LZS"
13;"Politinė partija „Lietuvos sąrašas“";"341";"25";"366";"1,75";"1,72";"Raudondvario";65;"LS"
10;"Lietuvos liaudies partija";"212";"10";"222";"1,06";"1,01";"Raudondvario";65;"LLP"
4;"S. Buškevičiaus ir Tautininkų koalicija „Prieš korupciją ir skurdą“ (Partija „Jaunoji Lietuva“, Tautininkų sąjunga)";"100";"6";"106";"0,51";"0,54";"Raudondvario";65;"JL"
9;"„Drąsos kelias“ politinė partija";"74";"8";"82";"0,39";"0,28";"Raudondvario";65;"DK"
2;"Tėvynės sąjunga - Lietuvos krikščionys demokratai";"4747";"399";"5146";"28,14";"21,66";"Garliavos";66;"TSLKD"
6;"Lietuvos valstiečių ir žaliųjų sąjunga";"4025";"185";"4210";"23,02";"21,54";"Garliavos";66;"LVZS"
1;"Lietuvos socialdemokratų partija";"2732";"198";"2930";"16,02";"14,43";"Garliavos";66;"LSDP"
7;"Lietuvos Respublikos liberalų sąjūdis";"1521";"102";"1623";"8,87";"9,04";"Garliavos";66;"LRLS"
14;"Antikorupcinė N. Puteikio ir K. Krivicko koalicija (Lietuvos centro partija, Lietuvos pensininkų partiją)";"1157";"49";"1206";"6,59";"6,06";"Garliavos";66;"PUTKA"
11;"Lietuvos lenkų rinkimų akcija-Krikščioniškų šeimų sąjunga";"22";"2";"24";"0,13";"5,49";"Garliavos";66;"LLRA"
5;"Partija Tvarka ir teisingumas";"445";"47";"492";"2,69";"5,33";"Garliavos";66;"PTT"
8;"Darbo partija";"449";"47";"496";"2,71";"4,69";"Garliavos";66;"DP"
3;"Lietuvos laisvės sąjunga (liberalai)";"206";"14";"220";"1,20";"2,14";"Garliavos";66;"LLS"
12;"Lietuvos žaliųjų partija";"365";"14";"379";"2,07";"1,94";"Garliavos";66;"LZS"
13;"Politinė partija „Lietuvos sąrašas“";"379";"8";"387";"2,12";"1,72";"Garliavos";66;"LS"
10;"Lietuvos liaudies partija";"179";"8";"187";"1,02";"1,01";"Garliavos";66;"LLP"
4;"S. Buškevičiaus ir Tautininkų koalicija „Prieš korupciją ir skurdą“ (Partija „Jaunoji Lietuva“, Tautininkų sąjunga)";"94";"9";"103";"0,56";"0,54";"Garliavos";66;"JL"
9;"„Drąsos kelias“ politinė partija";"246";"17";"263";"1,44";"0,28";"Garliavos";66;"DK"
2;"Tėvynės sąjunga - Lietuvos krikščionys demokratai";"2184";"532";"2716";"16,55";"21,66";"Prienų-Birštono";67;"TSLKD"
6;"Lietuvos valstiečių ir žaliųjų sąjunga";"2920";"530";"3450";"21,03";"21,54";"Prienų-Birštono";67;"LVZS"
1;"Lietuvos socialdemokratų partija";"3086";"860";"3946";"24,05";"14,43";"Prienų-Birštono";67;"LSDP"
7;"Lietuvos Respublikos liberalų sąjūdis";"675";"146";"821";"5,00";"9,04";"Prienų-Birštono";67;"LRLS"
14;"Antikorupcinė N. Puteikio ir K. Krivicko koalicija (Lietuvos centro partija, Lietuvos pensininkų partiją)";"776";"138";"914";"5,57";"6,06";"Prienų-Birštono";67;"PUTKA"
11;"Lietuvos lenkų rinkimų akcija-Krikščioniškų šeimų sąjunga";"21";"6";"27";"0,16";"5,49";"Prienų-Birštono";67;"LLRA"
5;"Partija Tvarka ir teisingumas";"1201";"419";"1620";"9,87";"5,33";"Prienų-Birštono";67;"PTT"
8;"Darbo partija";"376";"100";"476";"2,90";"4,69";"Prienų-Birštono";67;"DP"
3;"Lietuvos laisvės sąjunga (liberalai)";"230";"53";"283";"1,72";"2,14";"Prienų-Birštono";67;"LLS"
12;"Lietuvos žaliųjų partija";"280";"50";"330";"2,01";"1,94";"Prienų-Birštono";67;"LZS"
13;"Politinė partija „Lietuvos sąrašas“";"563";"96";"659";"4,02";"1,72";"Prienų-Birštono";67;"LS"
10;"Lietuvos liaudies partija";"111";"23";"134";"0,82";"1,01";"Prienų-Birštono";67;"LLP"
4;"S. Buškevičiaus ir Tautininkų koalicija „Prieš korupciją ir skurdą“ (Partija „Jaunoji Lietuva“, Tautininkų sąjunga)";"66";"25";"91";"0,55";"0,54";"Prienų-Birštono";67;"JL"
9;"„Drąsos kelias“ politinė partija";"120";"21";"141";"0,86";"0,28";"Prienų-Birštono";67;"DK"
2;"Tėvynės sąjunga - Lietuvos krikščionys demokratai";"1777";"424";"2201";"14,22";"21,66";"Vilkaviškio";68;"TSLKD"
6;"Lietuvos valstiečių ir žaliųjų sąjunga";"3732";"629";"4361";"28,18";"21,54";"Vilkaviškio";68;"LVZS"
1;"Lietuvos socialdemokratų partija";"3450";"732";"4182";"27,02";"14,43";"Vilkaviškio";68;"LSDP"
7;"Lietuvos Respublikos liberalų sąjūdis";"704";"135";"839";"5,42";"9,04";"Vilkaviškio";68;"LRLS"
14;"Antikorupcinė N. Puteikio ir K. Krivicko koalicija (Lietuvos centro partija, Lietuvos pensininkų partiją)";"1044";"178";"1222";"7,90";"6,06";"Vilkaviškio";68;"PUTKA"
11;"Lietuvos lenkų rinkimų akcija-Krikščioniškų šeimų sąjunga";"16";"2";"18";"0,12";"5,49";"Vilkaviškio";68;"LLRA"
5;"Partija Tvarka ir teisingumas";"463";"102";"565";"3,65";"5,33";"Vilkaviškio";68;"PTT"
8;"Darbo partija";"313";"90";"403";"2,60";"4,69";"Vilkaviškio";68;"DP"
3;"Lietuvos laisvės sąjunga (liberalai)";"86";"18";"104";"0,67";"2,14";"Vilkaviškio";68;"LLS"
12;"Lietuvos žaliųjų partija";"270";"46";"316";"2,04";"1,94";"Vilkaviškio";68;"LZS"
13;"Politinė partija „Lietuvos sąrašas“";"183";"28";"211";"1,36";"1,72";"Vilkaviškio";68;"LS"
10;"Lietuvos liaudies partija";"93";"23";"116";"0,75";"1,01";"Vilkaviškio";68;"LLP"
4;"S. Buškevičiaus ir Tautininkų koalicija „Prieš korupciją ir skurdą“ (Partija „Jaunoji Lietuva“, Tautininkų sąjunga)";"71";"11";"82";"0,53";"0,54";"Vilkaviškio";68;"JL"
9;"„Drąsos kelias“ politinė partija";"18";"8";"26";"0,17";"0,28";"Vilkaviškio";68;"DK"
2;"Tėvynės sąjunga - Lietuvos krikščionys demokratai";"3656";"937";"4593";"25,90";"21,66";"Dzūkijos";69;"TSLKD"
6;"Lietuvos valstiečių ir žaliųjų sąjunga";"3704";"478";"4182";"23,58";"21,54";"Dzūkijos";69;"LVZS"
1;"Lietuvos socialdemokratų partija";"2118";"409";"2527";"14,25";"14,43";"Dzūkijos";69;"LSDP"
7;"Lietuvos Respublikos liberalų sąjūdis";"763";"178";"941";"5,31";"9,04";"Dzūkijos";69;"LRLS"
14;"Antikorupcinė N. Puteikio ir K. Krivicko koalicija (Lietuvos centro partija, Lietuvos pensininkų partiją)";"1186";"115";"1301";"7,34";"6,06";"Dzūkijos";69;"PUTKA"
11;"Lietuvos lenkų rinkimų akcija-Krikščioniškų šeimų sąjunga";"65";"34";"99";"0,56";"5,49";"Dzūkijos";69;"LLRA"
5;"Partija Tvarka ir teisingumas";"712";"155";"867";"4,89";"5,33";"Dzūkijos";69;"PTT"
8;"Darbo partija";"940";"220";"1160";"6,54";"4,69";"Dzūkijos";69;"DP"
3;"Lietuvos laisvės sąjunga (liberalai)";"120";"36";"156";"0,88";"2,14";"Dzūkijos";69;"LLS"
12;"Lietuvos žaliųjų partija";"348";"50";"398";"2,24";"1,94";"Dzūkijos";69;"LZS"
13;"Politinė partija „Lietuvos sąrašas“";"159";"19";"178";"1,00";"1,72";"Dzūkijos";69;"LS"
10;"Lietuvos liaudies partija";"102";"30";"132";"0,74";"1,01";"Dzūkijos";69;"LLP"
4;"S. Buškevičiaus ir Tautininkų koalicija „Prieš korupciją ir skurdą“ (Partija „Jaunoji Lietuva“, Tautininkų sąjunga)";"65";"18";"83";"0,47";"0,54";"Dzūkijos";69;"JL"
9;"„Drąsos kelias“ politinė partija";"41";"12";"53";"0,30";"0,28";"Dzūkijos";69;"DK"
2;"Tėvynės sąjunga - Lietuvos krikščionys demokratai";"1851";"636";"2487";"15,17";"21,66";"Varėnos-Trakų";70;"TSLKD"
6;"Lietuvos valstiečių ir žaliųjų sąjunga";"2239";"665";"2904";"17,72";"21,54";"Varėnos-Trakų";70;"LVZS"
1;"Lietuvos socialdemokratų partija";"2519";"874";"3393";"20,70";"14,43";"Varėnos-Trakų";70;"LSDP"
7;"Lietuvos Respublikos liberalų sąjūdis";"1535";"476";"2011";"12,27";"9,04";"Varėnos-Trakų";70;"LRLS"
14;"Antikorupcinė N. Puteikio ir K. Krivicko koalicija (Lietuvos centro partija, Lietuvos pensininkų partiją)";"546";"151";"697";"4,25";"6,06";"Varėnos-Trakų";70;"PUTKA"
11;"Lietuvos lenkų rinkimų akcija-Krikščioniškų šeimų sąjunga";"981";"308";"1289";"7,86";"5,49";"Varėnos-Trakų";70;"LLRA"
5;"Partija Tvarka ir teisingumas";"528";"236";"764";"4,66";"5,33";"Varėnos-Trakų";70;"PTT"
8;"Darbo partija";"644";"312";"956";"5,83";"4,69";"Varėnos-Trakų";70;"DP"
3;"Lietuvos laisvės sąjunga (liberalai)";"266";"84";"350";"2,14";"2,14";"Varėnos-Trakų";70;"LLS"
12;"Lietuvos žaliųjų partija";"235";"57";"292";"1,78";"1,94";"Varėnos-Trakų";70;"LZS"
13;"Politinė partija „Lietuvos sąrašas“";"114";"26";"140";"0,85";"1,72";"Varėnos-Trakų";70;"LS"
10;"Lietuvos liaudies partija";"125";"38";"163";"0,99";"1,01";"Varėnos-Trakų";70;"LLP"
4;"S. Buškevičiaus ir Tautininkų koalicija „Prieš korupciją ir skurdą“ (Partija „Jaunoji Lietuva“, Tautininkų sąjunga)";"45";"32";"77";"0,47";"0,54";"Varėnos-Trakų";70;"JL"
9;"„Drąsos kelias“ politinė partija";"10";"8";"18";"0,11";"0,28";"Varėnos-Trakų";70;"DK"
2;"Tėvynės sąjunga - Lietuvos krikščionys demokratai";"3216";"993";"4209";"21,41";"21,66";"Lazdijų-Druskininkų";71;"TSLKD"
6;"Lietuvos valstiečių ir žaliųjų sąjunga";"3867";"798";"4665";"23,73";"21,54";"Lazdijų-Druskininkų";71;"LVZS"
1;"Lietuvos socialdemokratų partija";"3262";"754";"4016";"20,43";"14,43";"Lazdijų-Druskininkų";71;"LSDP"
7;"Lietuvos Respublikos liberalų sąjūdis";"863";"243";"1106";"5,63";"9,04";"Lazdijų-Druskininkų";71;"LRLS"
14;"Antikorupcinė N. Puteikio ir K. Krivicko koalicija (Lietuvos centro partija, Lietuvos pensininkų partiją)";"820";"143";"963";"4,90";"6,06";"Lazdijų-Druskininkų";71;"PUTKA"
11;"Lietuvos lenkų rinkimų akcija-Krikščioniškų šeimų sąjunga";"119";"10";"129";"0,66";"5,49";"Lazdijų-Druskininkų";71;"LLRA"
5;"Partija Tvarka ir teisingumas";"1057";"400";"1457";"7,41";"5,33";"Lazdijų-Druskininkų";71;"PTT"
8;"Darbo partija";"596";"195";"791";"4,02";"4,69";"Lazdijų-Druskininkų";71;"DP"
3;"Lietuvos laisvės sąjunga (liberalai)";"157";"30";"187";"0,95";"2,14";"Lazdijų-Druskininkų";71;"LLS"
12;"Lietuvos žaliųjų partija";"483";"87";"570";"2,90";"1,94";"Lazdijų-Druskininkų";71;"LZS"
13;"Politinė partija „Lietuvos sąrašas“";"229";"33";"262";"1,33";"1,72";"Lazdijų-Druskininkų";71;"LS"
10;"Lietuvos liaudies partija";"103";"25";"128";"0,65";"1,01";"Lazdijų-Druskininkų";71;"LLP"
4;"S. Buškevičiaus ir Tautininkų koalicija „Prieš korupciją ir skurdą“ (Partija „Jaunoji Lietuva“, Tautininkų sąjunga)";"58";"20";"78";"0,40";"0,54";"Lazdijų-Druskininkų";71;"JL"
9;"„Drąsos kelias“ politinė partija";"33";"6";"39";"0,20";"0,28";"Lazdijų-Druskininkų";71;"DK"
